Completed Date , Description , Paid Out (GBP) , Paid In (GBP) , Exchange Out, Exchange In, Balance (GBP), Category, Notes
29-Jan-19, To Holidays   ,1.02,  ,  ,  ,362.07, transfers, 
29-Jan-19, To Holidays   ,1.02,  ,  ,  ,363.09, transfers, 
29-Jan-19, To Holidays   ,0.6,  ,  ,  ,364.11, transfers, 
29-Jan-19, To Holidays   ,0.1,  ,  ,  ,364.71, transfers, 
28-Jan-19, From Luca Mircoli  ,  ,5,  ,  ,457.3, transfers, 
28-Jan-19, To Holidays   ,2,  ,  ,  ,452.3, transfers, 
28-Jan-19, To Holidays   ,1.06,  ,  ,  ,454.3, transfers, 
28-Jan-19, To Holidays   ,0.6,  ,  ,  ,455.36, transfers, 
28-Jan-19, To Holidays   ,0.6,  ,  ,  ,455.96, transfers, 
27-Jan-19, Payment from Grancharova T  ,  ,293,  ,  ,456.56, general, TV PAYMENT
27-Jan-19, To Holidays   ,0.02,  ,  ,  ,163.56, transfers, 
27-Jan-19, To Holidays   ,1.12,  ,  ,  ,163.58, transfers, 
27-Jan-19, Deliveroo  ,28.44,  ,  ,  ,364.81, groceries, 
26-Jan-19, From Luca Mircoli  ,  ,40,  ,  ,257.3, transfers, 
26-Jan-19, Cash at Kilburn Ug Station  ,20,  ,  ,  ,402.65, cash, 
26-Jan-19, From Holidays   ,  ,20,  ,  ,217.3, transfers, 
26-Jan-19, To Holidays   ,2,  ,  ,  ,197.3, transfers, 
26-Jan-19, Selfridges London  ,30,  ,  ,  ,423.65, shopping, 
26-Jan-19, To Holidays   ,1.2,  ,  ,  ,199.3, transfers, 
26-Jan-19, Ole & Steen  ,9.4,  ,  ,  ,393.25, groceries, 
26-Jan-19, To Holidays   ,0.7,  ,  ,  ,200.5, transfers, 
26-Jan-19, Pret A Manger  ,3.65,  ,  ,  ,453.65, restaurants, 
26-Jan-19, To Holidays   ,2,  ,  ,  ,201.2, transfers, 
26-Jan-19, M&S Bond Street Simply Food  ,1,  ,  ,  ,422.65, groceries, 
26-Jan-19, To Holidays   ,2,  ,  ,  ,305.1, transfers, 
26-Jan-19, C London  ,60,  ,  ,  ,185.8, restaurants, 
25-Jan-19, To Holidays   ,0.2,  ,  ,  ,307.1, transfers, 
25-Jan-19, Transport for London  ,2.9,  ,  ,  ,312.3, transport, 
25-Jan-19, To Holidays   ,1.7,  ,  ,  ,335, transfers, 
25-Jan-19, The Clachan  ,5.15,  ,  ,  ,180.65, restaurants, 
25-Jan-19, To Holidays   ,1,  ,  ,  ,336.7, transfers, 
25-Jan-19, Pret A Manger  ,1.5,  ,  ,  ,245.8, restaurants, 
25-Jan-19, Cash at Royal Bank of Scotland  ,10,  ,  ,  ,247.3, cash, 
25-Jan-19, To Holidays   ,0.1,  ,  ,  ,337.7, transfers, 
25-Jan-19, Badolina  ,15.95,  ,  ,  ,164.7, restaurants, 
24-Jan-19, To Holidays   ,1.62,  ,  ,  ,337.8, transfers, 
24-Jan-19, Temakinho  ,68.19,  ,  ,  ,203.2, restaurants, 
24-Jan-19, To Holidays   ,0.4,  ,  ,  ,339.42, transfers, 
24-Jan-19, Topshop  ,12.8,  ,  ,  ,292.3, shopping, 
24-Jan-19, To Holidays   ,1.5,  ,  ,  ,339.82, transfers, 
24-Jan-19, Marylebone  ,3.25,  ,  ,  ,271.39, restaurants, 
24-Jan-19, To Holidays   ,1.56,  ,  ,  ,341.32, transfers, 
24-Jan-19, Etnacoffee  ,9.22,  ,  ,  ,274.64, restaurants, 
24-Jan-19, To Holidays   ,1.12,  ,  ,  ,342.88, transfers, 
24-Jan-19, Pret A Manger  ,8.44,  ,  ,  ,283.86, restaurants, 
24-Jan-19, To Holidays   ,0.2,  ,  ,  ,349.55, transfers, 
24-Jan-19, Transport for London  ,2.9,  ,  ,  ,349.75, transport, 
23-Jan-19, To Luca Mircoli  ,15,  ,  ,  ,361.7, transfers, 
23-Jan-19, To Holidays   ,1.2,  ,  ,  ,386.1, transfers, 
23-Jan-19, Transport for London  ,2.4,  ,  ,  ,387.3, transport, 
23-Jan-19, To Holidays   ,2,  ,  ,  ,392.5, transfers, 
23-Jan-19, Arrow ECS  ,5,  ,  ,  ,307.3, restaurants, 
23-Jan-19, To Holidays   ,1.8,  ,  ,  ,394.5, transfers, 
23-Jan-19, UoW  ,5.1,  ,  ,  ,315.2, restaurants, 
23-Jan-19, To Holidays   ,0.6,  ,  ,  ,396.3, transfers, 
23-Jan-19, UoW  ,4.7,  ,  ,  ,320.3, restaurants, 
23-Jan-19, Exchange  to GBP FX Rate £1 = €1.1401 ,  ,87.71,  EUR 100.00 ,  ,396.9, general, 
23-Jan-19, From Holidays   ,  ,9.71,  ,  ,309.19, transfers, 
22-Jan-19, From Luca Mircoli  ,  ,178,  ,  ,299.48, transfers, 
22-Jan-19, To Holidays   ,1.9,  ,  ,  ,121.48, transfers, 
22-Jan-19, Hilco Supermarket Limited  ,9.05,  ,  ,  ,352.65, groceries, 
22-Jan-19, Cash at Royal Bank of Scotland  ,10,  ,  ,  ,325, cash, 
22-Jan-19, To Holidays   ,0.9,  ,  ,  ,123.38, transfers, 
22-Jan-19, UoW  ,1.55,  ,  ,  ,348, restaurants, 
22-Jan-19, To Holidays   ,2,  ,  ,  ,124.28, transfers, 
22-Jan-19, Marylebone  ,4,  ,  ,  ,344, restaurants, 
22-Jan-19, To Holidays   ,0.4,  ,  ,  ,126.28, transfers, 
22-Jan-19, Transport for London  ,2.8,  ,  ,  ,389.7, transport, 
22-Jan-19, To Holidays   ,0.4,  ,  ,  ,146.47, transfers, 
22-Jan-19, Transport for London  ,4.8,  ,  ,  ,146.87, transport, 
21-Jan-19, To Holidays   ,1.2,  ,  ,  ,162.65, transfers, 
21-Jan-19, Kastner & Ovens  ,9.4,  ,  ,  ,376.7, restaurants, 
20-Jan-19, Exchange  to GBP FX Rate £1 = €1.1385 ,  ,131.74,  EUR 150.00 ,  ,163.85, general, 
20-Jan-19, Transport for London  ,5.3,  ,  ,  ,98.17, transport, 
19-Jan-19, To Holidays   ,0.04,  ,  ,  ,170.86, transfers, 
19-Jan-19, Mayfair Food Fayre  ,10.98,  ,  ,  ,151.67, groceries, 
19-Jan-19, From Holidays   ,  ,7,  ,  ,197.34, transfers, 
18-Jan-19, To Holidays   ,0.42,  ,  ,  ,190.34, transfers, 
18-Jan-19, Deliveroo  ,19.79,  ,  ,  ,126.68, groceries, 
18-Jan-19, From Luca Mircoli  ,  ,10,  ,  ,190.76, transfers, 
18-Jan-19, To Holidays   ,1.88,  ,  ,  ,180.76, transfers, 
18-Jan-19, Uber Eats  ,16.06,  ,  ,  ,82.11, transport, 
18-Jan-19, To Holidays   ,0.2,  ,  ,  ,199.53, transfers, 
18-Jan-19, Transport for London  ,2.9,  ,  ,  ,199.73, transport, 
18-Jan-19, To Holidays   ,0.4,  ,  ,  ,202.63, transfers, 
18-Jan-19, Park Plaza Sherlock Holmes London  ,1.8,  ,  ,  ,169.06, restaurants, 
18-Jan-19, To Holidays   ,2,  ,  ,  ,203.03, transfers, 
18-Jan-19, Transport for London  ,7,  ,  ,  ,170.9, transport, 
17-Jan-19, Cash at Royal Bank of Scotland  ,50,  ,  ,  ,32.11, cash, 
17-Jan-19, To Holidays   ,0.82,  ,  ,  ,205.03, transfers, 
17-Jan-19, Burger & Lobster Mayfair  ,65.59,  ,  ,  ,103.47, restaurants, 
17-Jan-19, Exchange  to GBP FX Rate £1 = €1.1404 ,  ,131.52,  EUR 150.00 ,  ,205.85, general, 
17-Jan-19, To Holidays   ,0.8,  ,  ,  ,74.33, transfers, 
17-Jan-19, Marylebone  ,4.6,  ,  ,  ,177.9, restaurants, 
17-Jan-19, To Holidays   ,0.22,  ,  ,  ,75.13, transfers, 
17-Jan-19, itsu  ,12.89,  ,  ,  ,184.45, restaurants, 
17-Jan-19, To Holidays   ,0.1,  ,  ,  ,75.35, transfers, 
17-Jan-19, Marylebone  ,1.95,  ,  ,  ,182.5, restaurants, 
17-Jan-19, To Holidays   ,0.4,  ,  ,  ,277.88, transfers, 
17-Jan-19, Transport for London  ,4.8,  ,  ,  ,278.28, transport, 
16-Jan-19, From Holidays   ,  ,23,  ,  ,283.08, transfers, 
16-Jan-19, To Holidays   ,0.4,  ,  ,  ,260.08, transfers, 
16-Jan-19, Transport for London  ,4.8,  ,  ,  ,260.48, transport, 
16-Jan-19, To Holidays   ,1.72,  ,  ,  ,298.54, transfers, 
16-Jan-19, Park Plaza Sherlock Holmes London  ,14.14,  ,  ,  ,182.64, restaurants, 
16-Jan-19, To Holidays   ,0.5,  ,  ,  ,300.26, transfers, 
16-Jan-19, Pret A Manger  ,2.75,  ,  ,  ,196.78, restaurants, 
16-Jan-19, Exchange  to GBP FX Rate £1 = €1.1251 ,  ,47.99,  EUR 54.00 ,  ,300.76, general, 
15-Jan-19, To Bruno Arturo Fragnito  ,20,  ,  ,  ,252.77, transfers, 
15-Jan-19, To Holidays   ,0.1,  ,  ,  ,272.77, transfers, 
15-Jan-19, Marylebone  ,1.95,  ,  ,  ,275.93, restaurants, 
15-Jan-19, To Holidays   ,0.1,  ,  ,  ,272.87, transfers, 
15-Jan-19, Marylebone  ,1.95,  ,  ,  ,273.98, restaurants, 
15-Jan-19, To Holidays   ,1.4,  ,  ,  ,272.97, transfers, 
15-Jan-19, Marylebone  ,1.3,  ,  ,  ,272.68, restaurants, 
15-Jan-19, To Holidays   ,1.34,  ,  ,  ,274.37, transfers, 
15-Jan-19, The Ginger Pig  ,6.33,  ,  ,  ,232.35, groceries, 
14-Jan-19, To Holidays   ,0.38,  ,  ,  ,291.31, transfers, 
14-Jan-19, Tesco Superstore  ,6.81,  ,  ,  ,283.23, groceries, 
14-Jan-19, To Holidays   ,2,  ,  ,  ,291.69, transfers, 
14-Jan-19, Flat Iron  ,34,  ,  ,  ,238.68, restaurants, 
14-Jan-19, To Holidays   ,0.4,  ,  ,  ,593.08, transfers, 
14-Jan-19, Transport for London  ,4.8,  ,  ,  ,593.48, transport, 
14-Jan-19, To Holidays   ,0.4,  ,  ,  ,624.32, transfers, 
14-Jan-19, Transport for London  ,4.8,  ,  ,  ,624.72, transport, 
14-Jan-19, To Holidays   ,0.1,  ,  ,  ,629.52, transfers, 
14-Jan-19, Marylebone  ,2.95,  ,  ,  ,265.28, restaurants, 
14-Jan-19, To Holidays   ,0.2,  ,  ,  ,629.62, transfers, 
14-Jan-19, ELSA WU  ,156.9,  ,  ,  ,75.45, general, 
14-Jan-19, From Luca Mircoli  ,  ,157,  ,  ,629.82, transfers, 
14-Jan-19, To Holidays   ,0.4,  ,  ,  ,472.82, transfers, 
14-Jan-19, Sainsbury's  ,9.8,  ,  ,  ,273.43, groceries, 
14-Jan-19, To Holidays   ,1,  ,  ,  ,473.22, transfers, 
14-Jan-19, Etnacoffee  ,8.5,  ,  ,  ,290.04, restaurants, 
14-Jan-19, To Holidays   ,1.6,  ,  ,  ,474.22, transfers, 
14-Jan-19, Marylebone  ,5.2,  ,  ,  ,268.23, restaurants, 
14-Jan-19, To Holidays   ,2,  ,  ,  ,475.82, transfers, 
14-Jan-19, Transport for London  ,7,  ,  ,  ,275.71, transport, 
13-Jan-19, Exchange  to GBP FX Rate £1 = €1.1260 ,  ,142.97,  EUR 161.00 ,  ,477.82, general, 
13-Jan-19, To Holidays   ,2,  ,  ,  ,334.85, transfers, 
13-Jan-19, Boots  ,4,  ,  ,  ,287.31, health, 
13-Jan-19, To Holidays   ,0.8,  ,  ,  ,336.85, transfers, 
13-Jan-19, Pret A Manger  ,4.6,  ,  ,  ,282.71, restaurants, 
12-Jan-19, From Luca Mircoli  ,  ,10,  ,  ,360.25, transfers, 
12-Jan-19, To Holidays   ,1.22,  ,  ,  ,350.25, transfers, 
12-Jan-19, Buongiorno e Buonasera  ,12.39,  ,  ,  ,609.98, restaurants, 
12-Jan-19, To Holidays   ,1.6,  ,  ,  ,351.47, transfers, 
12-Jan-19, Marylebone  ,5.2,  ,  ,  ,602.18, restaurants, 
12-Jan-19, To Holidays   ,0.2,  ,  ,  ,353.07, transfers, 
12-Jan-19, ELSA WU  ,295.9,  ,  ,  ,293.69, general, 
12-Jan-19, From Holidays   ,  ,2,  ,  ,353.27, transfers, 
12-Jan-19, Exchange  to GBP FX Rate £1 = €1.1259 ,  ,310.84,  EUR 350.00 ,  ,351.27, general, 
12-Jan-19, To Holidays   ,0.8,  ,  ,  ,40.43, transfers, 
12-Jan-19, Lexington Catering  ,2.6,  ,  ,  ,607.38, restaurants, 
12-Jan-19, To Holidays   ,0.1,  ,  ,  ,41.23, transfers, 
12-Jan-19, Lexington Catering  ,1.95,  ,  ,  ,622.37, restaurants, 
12-Jan-19, To Holidays   ,1.02,  ,  ,  ,41.33, transfers, 
12-Jan-19, Pret A Manger  ,3.49,  ,  ,  ,589.59, restaurants, 
12-Jan-19, To Holidays   ,0.2,  ,  ,  ,44.3, transfers, 
12-Jan-19, Transport for London  ,3.9,  ,  ,  ,44.5, transport, 
11-Jan-19, To Luca Mircoli  ,10,  ,  ,  ,58.49, transfers, 
11-Jan-19, From Holidays   ,  ,22,  ,  ,68.49, transfers, 
11-Jan-19, To Holidays   ,0.2,  ,  ,  ,46.49, transfers, 
11-Jan-19, Marylebone  ,3.9,  ,  ,  ,598.28, restaurants, 
11-Jan-19, To Holidays   ,0.7,  ,  ,  ,46.69, transfers, 
11-Jan-19, Etnacoffee  ,7.65,  ,  ,  ,337.65, restaurants, 
11-Jan-19, To Holidays   ,1.7,  ,  ,  ,47.39, transfers, 
11-Jan-19, Marylebone  ,3.15,  ,  ,  ,357.1, restaurants, 
11-Jan-19, Marylebone  ,1.95,  ,  ,  ,49.09, restaurants, 
11-Jan-19, Transport for London  ,4.8,  ,  ,  ,51.04, transport, 
10-Jan-19, To Holidays   ,0.4,  ,  ,  ,55.84, transfers, 
10-Jan-19, Arrow ECS  ,11.8,  ,  ,  ,345.3, restaurants, 
10-Jan-19, To Holidays   ,0.1,  ,  ,  ,56.24, transfers, 
10-Jan-19, Marylebone  ,1.95,  ,  ,  ,42.35, restaurants, 
10-Jan-19, To Holidays   ,1.82,  ,  ,  ,56.34, transfers, 
10-Jan-19, Park Plaza Sherlock Holmes London  ,10.09,  ,  ,  ,48.4, restaurants, 
10-Jan-19, From Holidays   ,  ,50,  ,  ,58.16, transfers, 
10-Jan-19, Fierce Grace  ,13,  ,  ,  ,8.16, health, 
10-Jan-19, The Japanese Canteen  ,20.52,  ,  ,  ,21.16, restaurants, 
10-Jan-19, Pizza Union  ,4.95,  ,  ,  ,41.68, restaurants, 
10-Jan-19, To Holidays   ,0.4,  ,  ,  ,46.63, transfers, 
09-Jan-19, To Holidays   ,0.1,  ,  ,  ,47.03, transfers, 
09-Jan-19, To Holidays   ,50,  ,  ,  ,47.13, transfers, 
09-Jan-19, Netflix HQ  ,9.99,  ,  ,  ,97.13, utilities, 
09-Jan-19, Cash at HSBC Bank Plc  ,10,  ,  ,  ,107.12, cash, 
09-Jan-19, Arrow ECS  ,5.7,  ,  ,  ,117.12, restaurants, 
09-Jan-19, Chipotle Mexican Grill  ,12.45,  ,  ,  ,122.82, restaurants, 
09-Jan-19, To Holidays   ,0.4,  ,  ,  ,135.27, transfers, 
09-Jan-19, Transport for London  ,4.8,  ,  ,  ,135.67, transport, 
09-Jan-19, Pret A Manger  ,7.03,  ,  ,  ,140.47, restaurants, 
08-Jan-19, To Holidays   ,0.1,  ,  ,  ,147.5, transfers, 
08-Jan-19, To Holidays   ,0.96,  ,  ,  ,147.6, transfers, 
08-Jan-19, London Visitors  ,34.88,  ,  ,  ,148.56, restaurants, 
08-Jan-19, To Holidays   ,0.4,  ,  ,  ,183.44, transfers, 
08-Jan-19, Transport for London  ,4.8,  ,  ,  ,183.84, transport, 
08-Jan-19, Wasabi Sushi & Bento  ,10.95,  ,  ,  ,188.64, restaurants, 
08-Jan-19, UNIQLO Europe Limited  ,29.9,  ,  ,  ,199.59, shopping, 
08-Jan-19, Where 2 Save  ,5.28,  ,  ,  ,229.49, groceries, 
08-Jan-19, To Holidays   ,2,  ,  ,  ,234.77, transfers, 
07-Jan-19, Payment from S Bertani  ,  ,50,  ,  ,236.77, general, 
07-Jan-19, To Holidays   ,0.02,  ,  ,  ,186.77, transfers, 
06-Jan-19, To Sara Virgin  ,50,  ,  ,  ,186.79, transfers, palestra
06-Jan-19, From Holidays   ,  ,20,  ,  ,236.79, transfers, 
06-Jan-19, From Holidays   ,  ,50,  ,  ,216.79, transfers, 
06-Jan-19, To Holidays   ,0.6,  ,  ,  ,166.79, transfers, 
06-Jan-19, To Holidays   ,1.1,  ,  ,  ,167.39, transfers, 
06-Jan-19, To Holidays   ,1.94,  ,  ,  ,168.49, transfers, 
06-Jan-19, Cash at Kilburn Ug Station  ,20,  ,  ,  ,170.43, cash, 
06-Jan-19, Planet Organic  ,16.57,  ,  ,  ,190.43, groceries, 
06-Jan-19, Transport for London  ,5.3,  ,  ,  ,207, transport, 
05-Jan-19, From Luca Mircoli  ,  ,17.44,  ,  ,212.3, transfers, W London - Leicester Square
05-Jan-19, To Holidays   ,0.24,  ,  ,  ,194.86, transfers, 
05-Jan-19, To Holidays   ,0.1,  ,  ,  ,195.1, transfers, 
05-Jan-19, To Holidays   ,0.2,  ,  ,  ,195.2, transfers, 
05-Jan-19, Exchange  to GBP FX Rate £1 = €1.1228 ,  ,138.04,  EUR 155.00 ,  ,195.4, general, 
05-Jan-19, From Giacomo Maravalle  ,  ,7.25,  ,  ,57.36, transfers, 
05-Jan-19, Pret A Manger  ,2.75,  ,  ,  ,50.11, restaurants, 
05-Jan-19, itsu  ,7.72,  ,  ,  ,52.86, restaurants, 
05-Jan-19, To Holidays   ,1.4,  ,  ,  ,60.58, transfers, 
04-Jan-19, To Holidays   ,1.44,  ,  ,  ,61.98, transfers, 
04-Jan-19, To Holidays   ,0.86,  ,  ,  ,63.42, transfers, 
04-Jan-19, Cash at Royal Bank of Scotland  ,20,  ,  ,  ,64.28, cash, 
04-Jan-19, To Holidays   ,1.4,  ,  ,  ,84.28, transfers, 
04-Jan-19, Transport for London  ,5.3,  ,  ,  ,85.68, transport, 
04-Jan-19, Uber Eats  ,15.47,  ,  ,  ,90.98, transport, 
04-Jan-19, Pret A Manger  ,5.5,  ,  ,  ,106.45, restaurants, 
04-Jan-19, Wasabi Sushi & Bento  ,14.6,  ,  ,  ,111.95, restaurants, 
04-Jan-19, Ryman  ,12.53,  ,  ,  ,126.55, utilities, 
03-Jan-19, To Holidays   ,0.56,  ,  ,  ,139.08, transfers, 
03-Jan-19, To Holidays   ,1.2,  ,  ,  ,139.64, transfers, 
03-Jan-19, Transport for London  ,2.4,  ,  ,  ,140.84, transport, 
03-Jan-19, Duke of Wellington  ,22.5,  ,  ,  ,143.24, restaurants, 
03-Jan-19, Tesco Express  ,11.55,  ,  ,  ,165.74, groceries, 
03-Jan-19, Greater Anglia  ,17,  ,  ,  ,177.29, transport, 
03-Jan-19, Uber Eats  ,8.61,  ,  ,  ,194.29, transport, 
03-Jan-19, To Holidays   ,0.5,  ,  ,  ,202.9, transfers, 
02-Jan-19, Transport for London  ,4.8,  ,  ,  ,203.4, transport, 
02-Jan-19, To Holidays   ,0.8,  ,  ,  ,208.2, transfers, 
02-Jan-19, To Holidays   ,0.94,  ,  ,  ,209, transfers, 
02-Jan-19, To Holidays   ,1,  ,  ,  ,209.94, transfers, 
02-Jan-19, To Holidays   ,2,  ,  ,  ,210.94, transfers, 
01-Jan-19, To Holidays   ,0.9,  ,  ,  ,212.94, transfers, 
01-Jan-19, To Holidays   ,2,  ,  ,  ,213.84, transfers, 
01-Jan-19, To Holidays   ,1,  ,  ,  ,215.84, transfers, 
01-Jan-19, Payment from L Maresca  ,  ,170,  ,  ,216.84, general, MONEY TRANSFER
01-Jan-19, To Holidays   ,2,  ,  ,  ,46.84, transfers, 
01-Jan-19, Google aclap Sarl  ,13.49,  ,  ,  ,48.84, shopping, 
01-Jan-19, To Holidays   ,0.4,  ,  ,  ,62.33, transfers, 
31-Dec-18, To Lorenz Maresca  ,675,  ,  ,  ,62.73, transfers, 
31-Dec-18, From Luca Mircoli  ,  ,665,  ,  ,737.73, transfers, 
30-Dec-18, To Holidays   ,1.02,  ,  ,  ,72.73, transfers, 
30-Dec-18, Uber Eats  ,5,  ,  ,  ,73.75, transport, 
30-Dec-18, Trainline  ,17,  ,  ,  ,78.75, transport, 
30-Dec-18, Costa Coffee  ,1.35,  ,  ,  ,95.75, restaurants, 
29-Dec-18, To Holidays   ,2,  ,  ,  ,97.1, transfers, 
29-Dec-18, Kilburn Station  ,10,  ,  ,  ,99.1, transport, 
29-Dec-18, Costa Coffee  ,3.5,  ,  ,  ,109.1, restaurants, 
29-Dec-18, To Holidays   ,0.4,  ,  ,  ,112.6, transfers, 
29-Dec-18, Transport for London  ,2.8,  ,  ,  ,113, transport, 
29-Dec-18, Lima London  ,16.02,  ,  ,  ,115.8, restaurants, 
29-Dec-18, To Holidays   ,0.4,  ,  ,  ,131.82, transfers, 
29-Dec-18, Transport for London  ,4.8,  ,  ,  ,132.22, transport, 
29-Dec-18, Uber Eats  ,15.58,  ,  ,  ,137.02, transport, 
29-Dec-18, Ents 24  ,24,  ,  ,  ,152.6, entertainment, 
28-Dec-18, To Holidays   ,2,  ,  ,  ,176.6, transfers, 
28-Dec-18, To Holidays   ,2,  ,  ,  ,178.6, transfers, 
28-Dec-18, Cash at Po Mill Lane 2221  ,100,  ,  ,  ,180.6, cash, 
28-Dec-18, Boots  ,14.04,  ,  ,  ,280.6, health, 
28-Dec-18, To Holidays   ,0.2,  ,  ,  ,294.64, transfers, 
28-Dec-18, Transport for London  ,2.9,  ,  ,  ,294.84, transport, 
28-Dec-18, Pret A Manger  ,8.34,  ,  ,  ,297.74, restaurants, 
28-Dec-18, To Holidays   ,2,  ,  ,  ,306.08, transfers, 
28-Dec-18, To Holidays   ,2,  ,  ,  ,308.08, transfers, 
28-Dec-18, To Holidays   ,1.3,  ,  ,  ,310.08, transfers, 
28-Dec-18, itsu  ,0.99,  ,  ,  ,311.38, restaurants, 
28-Dec-18, itsu  ,17.91,  ,  ,  ,312.37, restaurants, 
28-Dec-18, Tesco Superstore  ,4.19,  ,  ,  ,330.28, groceries, 
28-Dec-18, Tesco Superstore  ,1.05,  ,  ,  ,334.47, groceries, 
28-Dec-18, Paul Smith Avery Row  ,83,  ,  ,  ,335.52, shopping, 
28-Dec-18, To Holidays   ,1.2,  ,  ,  ,418.52, transfers, 
28-Dec-18, Transport for London  ,2.4,  ,  ,  ,419.72, transport, 
28-Dec-18, Whole Foods Market  ,4.99,  ,  ,  ,422.12, groceries, 
28-Dec-18, To Holidays   ,2,  ,  ,  ,427.11, transfers, 
27-Dec-18, To Holidays   ,1,  ,  ,  ,429.11, transfers, 
27-Dec-18, To Holidays   ,2,  ,  ,  ,430.11, transfers, 
26-Dec-18, To Holidays   ,1.96,  ,  ,  ,432.11, transfers, 
25-Dec-18, To Holidays   ,0.84,  ,  ,  ,434.07, transfers, 
25-Dec-18, To Luciana Fendi  ,60,  ,  ,  ,434.91, transfers, 
25-Dec-18, To Holidays   ,2,  ,  ,  ,494.91, transfers, 
24-Dec-18, To Holidays   ,1.92,  ,  ,  ,496.91, transfers, 
24-Dec-18, To Holidays   ,1.32,  ,  ,  ,498.83, transfers, 
23-Dec-18, Cash at Royal Bank of Scotland  ,10,  ,  ,  ,500.15, cash, 
23-Dec-18, Ronis Bagel Bakery  ,2.9,  ,  ,  ,510.15, groceries, 
23-Dec-18, Waitrose  ,6.64,  ,  ,  ,513.05, groceries, 
22-Dec-18, To Holidays   ,1.62,  ,  ,  ,519.69, transfers, 
22-Dec-18, To Holidays   ,1.9,  ,  ,  ,521.31, transfers, 
22-Dec-18, To Holidays   ,2,  ,  ,  ,523.21, transfers, 
22-Dec-18, To Holidays   ,0.02,  ,  ,  ,525.21, transfers, 
22-Dec-18, To Holidays   ,0.02,  ,  ,  ,525.23, transfers, 
22-Dec-18, To Holidays   ,0.18,  ,  ,  ,525.25, transfers, 
22-Dec-18, Amazon  ,19,  ,  ,  ,525.43, shopping, 
22-Dec-18, Pret A Manger  ,9.35,  ,  ,  ,544.43, restaurants, 
22-Dec-18, Transport for London  ,5.3,  ,  ,  ,553.78, transport, 
22-Dec-18, itsu  ,10.43,  ,  ,  ,559.08, restaurants, 
21-Dec-18, Exchange  to GBP FX Rate £1 = €1.1101 ,  ,450.38,  EUR 500.00 ,  ,569.51, general, 
21-Dec-18, To Holidays   ,0.72,  ,  ,  ,119.13, transfers, 
21-Dec-18, To Holidays   ,0.2,  ,  ,  ,119.85, transfers, 
21-Dec-18, Wasabi Sushi & Bento  ,1.3,  ,  ,  ,120.05, restaurants, 
21-Dec-18, Newsmart  ,9,  ,  ,  ,121.35, shopping, 
21-Dec-18, Tesco Superstore  ,16.45,  ,  ,  ,130.35, groceries, 
21-Dec-18, itsu  ,14.68,  ,  ,  ,146.8, restaurants, 
21-Dec-18, To Holidays   ,0.2,  ,  ,  ,161.48, transfers, 
21-Dec-18, Transport for London  ,2.9,  ,  ,  ,161.68, transport, 
21-Dec-18, To Holidays   ,1.4,  ,  ,  ,164.58, transfers, 
20-Dec-18, To Holidays   ,1.14,  ,  ,  ,165.98, transfers, 
20-Dec-18, To Holidays   ,1.4,  ,  ,  ,167.12, transfers, 
20-Dec-18, Transport for London  ,5.3,  ,  ,  ,168.52, transport, 
20-Dec-18, Sunflower Cafe  ,8.5,  ,  ,  ,173.82, restaurants, 
20-Dec-18, To Holidays   ,1.3,  ,  ,  ,182.32, transfers, 
19-Dec-18, To Holidays   ,1.1,  ,  ,  ,183.62, transfers, 
19-Dec-18, To Holidays   ,1.4,  ,  ,  ,184.72, transfers, 
19-Dec-18, To Holidays   ,0.64,  ,  ,  ,186.12, transfers, 
19-Dec-18, To Holidays   ,2,  ,  ,  ,186.76, transfers, 
19-Dec-18, To Holidays   ,2,  ,  ,  ,188.76, transfers, 
19-Dec-18, Cash at Royal Bank of Scotland  ,20,  ,  ,  ,190.76, cash, 
19-Dec-18, To Holidays   ,1.2,  ,  ,  ,210.76, transfers, 
19-Dec-18, Transport for London  ,2.4,  ,  ,  ,211.96, transport, 
19-Dec-18, Pret A Manger  ,2.75,  ,  ,  ,214.36, restaurants, 
19-Dec-18, Sunflower Cafe  ,7.95,  ,  ,  ,217.11, restaurants, 
19-Dec-18, Chiltern Firehouse  ,10,  ,  ,  ,225.06, restaurants, 
19-Dec-18, To Holidays   ,2,  ,  ,  ,235.06, transfers, 
18-Dec-18, To Holidays   ,1,  ,  ,  ,237.06, transfers, 
18-Dec-18, Cash at Royal Bank of Scotland  ,10,  ,  ,  ,238.06, cash, 
18-Dec-18, James News  ,11.99,  ,  ,  ,248.06, shopping, 
18-Dec-18, To Holidays   ,0.2,  ,  ,  ,260.05, transfers, 
18-Dec-18, Transport for London  ,3.9,  ,  ,  ,260.25, transport, 
18-Dec-18, Boots  ,1.3,  ,  ,  ,264.15, health, 
18-Dec-18, Flying Tiger Copenhagen  ,24,  ,  ,  ,265.45, health, 
18-Dec-18, N V S Pharmacy  ,6.99,  ,  ,  ,289.45, health, 
18-Dec-18, Buongiorno e Buonasera  ,13.93,  ,  ,  ,296.44, restaurants, 
17-Dec-18, Selfridges London  ,3.75,  ,  ,  ,310.37, shopping, 
17-Dec-18, Selfridges London  ,14.96,  ,  ,  ,314.12, shopping, 
17-Dec-18, Lima London  ,16.02,  ,  ,  ,329.08, restaurants, 
17-Dec-18, To Holidays   ,0.4,  ,  ,  ,345.1, transfers, 
17-Dec-18, Transport for London  ,4.8,  ,  ,  ,345.5, transport, 
17-Dec-18, Exchange  to GBP FX Rate £1 = €1.1121 ,  ,179.82,  EUR 200.00 ,  ,350.3, general, 
17-Dec-18, To Holidays   ,0.1,  ,  ,  ,170.48, transfers, 
17-Dec-18, To Holidays   ,0.5,  ,  ,  ,170.58, transfers, 
17-Dec-18, To Holidays   ,0.2,  ,  ,  ,171.08, transfers, 
17-Dec-18, From Holidays   ,  ,35,  ,  ,171.28, transfers, 
16-Dec-18, To Holidays   ,0.02,  ,  ,  ,136.28, transfers, 
16-Dec-18, To Holidays   ,2,  ,  ,  ,136.3, transfers, 
16-Dec-18, To Holidays   ,2,  ,  ,  ,138.3, transfers, 
16-Dec-18, To Holidays   ,1.4,  ,  ,  ,140.3, transfers, 
16-Dec-18, To Holidays   ,0.02,  ,  ,  ,141.7, transfers, 
16-Dec-18, To Holidays   ,0.14,  ,  ,  ,141.72, transfers, 
16-Dec-18, To Holidays   ,0.4,  ,  ,  ,141.86, transfers, 
16-Dec-18, Transport for London  ,6.8,  ,  ,  ,142.26, transport, 
16-Dec-18, Sainsbury's  ,22.37,  ,  ,  ,149.06, groceries, 
16-Dec-18, Habitat Finchley Road  ,7.2,  ,  ,  ,171.43, utilities, 
16-Dec-18, Homebase - London Acton  ,29,  ,  ,  ,178.63, utilities, 
16-Dec-18, Mr Lee  ,8.7,  ,  ,  ,207.63, shopping, 
15-Dec-18, From Luca Mircoli  ,  ,4.8,  ,  ,216.33, transfers, 
15-Dec-18, To Holidays   ,0.5,  ,  ,  ,211.53, transfers, 
15-Dec-18, To Holidays   ,0.08,  ,  ,  ,212.03, transfers, 
15-Dec-18, Cash at Royal Bank of Scotland  ,10,  ,  ,  ,212.11, cash, 
15-Dec-18, Uber Eats  ,7.05,  ,  ,  ,222.11, transport, 
15-Dec-18, Sunflower Cafe  ,9.5,  ,  ,  ,229.16, restaurants, 
15-Dec-18, Newsmart  ,9,  ,  ,  ,238.66, shopping, 
15-Dec-18, Pret A Manger  ,3.99,  ,  ,  ,247.66, restaurants, 
14-Dec-18, To Holidays   ,1.96,  ,  ,  ,251.65, transfers, 
14-Dec-18, To Holidays   ,1.6,  ,  ,  ,253.61, transfers, 
14-Dec-18, To Holidays   ,1.26,  ,  ,  ,255.21, transfers, 
14-Dec-18, To Holidays   ,2,  ,  ,  ,256.47, transfers, 
14-Dec-18, To Holidays   ,0.6,  ,  ,  ,258.47, transfers, 
14-Dec-18, Transport for London  ,6.8,  ,  ,  ,259.07, transport, 
14-Dec-18, Pret A Manger  ,2.75,  ,  ,  ,265.87, restaurants, 
14-Dec-18, Sunflower Cafe  ,8,  ,  ,  ,268.62, restaurants, 
14-Dec-18, Tesco Superstore  ,5,  ,  ,  ,276.62, groceries, 
13-Dec-18, To Holidays   ,2,  ,  ,  ,281.62, transfers, 
13-Dec-18, To Holidays   ,1,  ,  ,  ,283.62, transfers, 
13-Dec-18, To Holidays   ,0.02,  ,  ,  ,284.62, transfers, 
13-Dec-18, Tesco Superstore  ,10.45,  ,  ,  ,284.64, groceries, 
13-Dec-18, Newsmart  ,9,  ,  ,  ,295.09, shopping, 
13-Dec-18, Pret A Manger  ,5.5,  ,  ,  ,304.09, restaurants, 
13-Dec-18, itsu  ,22.24,  ,  ,  ,309.59, restaurants, 
13-Dec-18, To Holidays   ,2,  ,  ,  ,331.83, transfers, 
13-Dec-18, To Holidays   ,0.4,  ,  ,  ,333.83, transfers, 
12-Dec-18, To Holidays   ,2,  ,  ,  ,334.23, transfers, 
12-Dec-18, To Holidays   ,2,  ,  ,  ,336.23, transfers, 
12-Dec-18, Newsmart  ,9,  ,  ,  ,338.23, shopping, 
12-Dec-18, Tesco Superstore  ,11.7,  ,  ,  ,347.23, groceries, 
12-Dec-18, Wasabi Sushi & Bento  ,11.8,  ,  ,  ,358.93, restaurants, 
12-Dec-18, Lse Catering  ,3.2,  ,  ,  ,370.73, restaurants, 
12-Dec-18, To Holidays   ,0.5,  ,  ,  ,373.93, transfers, 
11-Dec-18, To Holidays   ,1.1,  ,  ,  ,374.43, transfers, 
11-Dec-18, To Holidays   ,2,  ,  ,  ,375.53, transfers, 
11-Dec-18, To Holidays   ,1.52,  ,  ,  ,377.53, transfers, 
11-Dec-18, To Lorenz Maresca  ,20,  ,  ,  ,379.05, transfers, 
11-Dec-18, Exchange  to GBP FX Rate £1 = €1.1074 ,  ,355.17,  EUR 393.33 ,  ,399.05, general, 
11-Dec-18, To Holidays   ,1,  ,  ,  ,43.88, transfers, 
10-Dec-18, To Holidays   ,0.2,  ,  ,  ,44.88, transfers, 
10-Dec-18, Transport for London  ,3.9,  ,  ,  ,45.08, transport, 
10-Dec-18, To Holidays   ,0.6,  ,  ,  ,48.98, transfers, 
10-Dec-18, To Holidays   ,1.6,  ,  ,  ,49.58, transfers, 
10-Dec-18, To Luca Mircoli  ,20,  ,  ,  ,51.18, transfers, 
10-Dec-18, Payment from L Maresca  ,  ,33.85,  ,  ,71.18, general, MONEY TRANSFER
10-Dec-18, To Holidays   ,0.4,  ,  ,  ,37.33, transfers, 
10-Dec-18, To Holidays   ,2,  ,  ,  ,37.73, transfers, 
10-Dec-18, To Sara Virgin  ,50,  ,  ,  ,39.73, transfers, palestra
10-Dec-18, Exchange  to GBP FX Rate £1 = €1.1144 ,  ,89.73,  EUR 100.00 ,  ,89.73, general, 
09-Dec-18, To Lorenz Maresca  ,30,  ,  ,  ,0, transfers, 
09-Dec-18, From Holidays   ,  ,29,  ,  ,30, transfers, 
09-Dec-18, Netflix HQ  ,9.99,  ,  ,  ,1, utilities, 
09-Dec-18, Transport for London  ,2.4,  ,  ,  ,10.99, transport, 
09-Dec-18, Transport for London  ,5.3,  ,  ,  ,13.39, transport, 
09-Dec-18, Uber Eats  ,19.12,  ,  ,  ,18.69, transport, 
08-Dec-18, Ryanair  ,45.99,  ,  ,  ,37.81, travel, 
08-Dec-18, Tesco Superstore  ,21.33,  ,  ,  ,83.8, groceries, 
07-Dec-18, To Holidays   ,1.76,  ,  ,  ,105.13, transfers, 
07-Dec-18, From Giacomo Maravalle  ,  ,20,  ,  ,106.89, transfers, 
07-Dec-18, To Lorenz Maresca  ,35,  ,  ,  ,86.89, transfers, 
07-Dec-18, easyJet Hangar 89 FX Rate £1 = €1.1209 ,88.14,  ,  EUR 98.80 ,  ,121.89, travel, 
07-Dec-18, To Holidays   ,1.4,  ,  ,  ,210.03, transfers, 
07-Dec-18, To Holidays   ,0.02,  ,  ,  ,211.43, transfers, 
06-Dec-18, To Holidays   ,1.34,  ,  ,  ,211.45, transfers, 
05-Dec-18, Refund from Uber Eats Kqmxe Help.uber  ,  ,6.58,  ,  ,212.79, transport, 
05-Dec-18, Refund from Uber Eats Qttyf Help.uber  ,  ,4.49,  ,  ,206.21, transport, 
05-Dec-18, Uber Eats  ,17.06,  ,  ,  ,201.72, transport, 
05-Dec-18, Uber Eats  ,11.48,  ,  ,  ,218.78, transport, 
05-Dec-18, To Holidays   ,1.72,  ,  ,  ,230.26, transfers, 
05-Dec-18, To Holidays   ,0.02,  ,  ,  ,231.98, transfers, 
04-Dec-18, To Holidays   ,1.2,  ,  ,  ,232, transfers, 
04-Dec-18, Transport for London  ,2.4,  ,  ,  ,233.2, transport, 
04-Dec-18, To Holidays   ,1.2,  ,  ,  ,235.6, transfers, 
04-Dec-18, Transport for London  ,2.4,  ,  ,  ,236.8, transport, 
04-Dec-18, Nyx healthyvendingco  ,1,  ,  ,  ,239.2, groceries, 
04-Dec-18, Primark  ,3.5,  ,  ,  ,240.2, shopping, 
04-Dec-18, To Holidays   ,1.2,  ,  ,  ,243.7, transfers, 
03-Dec-18, To Holidays   ,1.04,  ,  ,  ,244.9, transfers, 
03-Dec-18, To Holidays   ,0.2,  ,  ,  ,245.94, transfers, 
03-Dec-18, Transport for London  ,2.9,  ,  ,  ,246.14, transport, 
03-Dec-18, Pret A Manger  ,2.75,  ,  ,  ,249.04, restaurants, 
03-Dec-18, Sunflower Cafe  ,8.5,  ,  ,  ,251.79, restaurants, 
03-Dec-18, Nelhart News  ,8.99,  ,  ,  ,260.29, shopping, 
03-Dec-18, Sunflower Cafe  ,9.5,  ,  ,  ,269.28, restaurants, 
03-Dec-18, Sainsbury's  ,2.2,  ,  ,  ,278.78, groceries, 
03-Dec-18, To Holidays   ,1.88,  ,  ,  ,280.98, transfers, 
03-Dec-18, To Christopher Maclean  ,200,  ,  ,  ,282.86, transfers, month of November
03-Dec-18, Exchange  to GBP FX Rate £1 = €1.1218 ,  ,445.68,  EUR 500.00 ,  ,482.86, general, 
01-Dec-18, To Holidays   ,2,  ,  ,  ,37.18, transfers, 
01-Dec-18, To Christopher Maclean  ,1,,,,,,
30-Nov-18, To Holidays   ,1,  ,  ,  ,1,,
30-Nov-18, Payment from L Maresca  ,  ,845,  ,  ,1,,
29-Nov-18, To Dina Radenkovich  ,115,  ,  ,  ,395.18, transfers, 
29-Nov-18, To Holidays   ,1,  ,  ,  ,510.18, transfers, 
29-Nov-18, Mother Group Ltd  ,2.25,  ,  ,  ,511.18, groceries, 
29-Nov-18, Pret A Manger  ,2.75,  ,  ,  ,513.43, restaurants, 
29-Nov-18, The Japanese Canteen  ,23.67,  ,  ,  ,516.18, restaurants, 
29-Nov-18, Sunflower Cafe  ,8,  ,  ,  ,539.85, restaurants, 
29-Nov-18, To Holidays   ,0.5,  ,  ,  ,547.85, transfers, 
28-Nov-18, From Luca Mircoli  ,  ,10,  ,  ,548.35, transfers, 
28-Nov-18, To Luca Mircoli  ,10,  ,  ,  ,538.35, transfers, 
28-Nov-18, To Holidays   ,1.6,  ,  ,  ,548.35, transfers, 
28-Nov-18, To Holidays   ,0.02,  ,  ,  ,549.95, transfers, 
28-Nov-18, To Holidays   ,1,  ,  ,  ,549.97, transfers, 
28-Nov-18, Pret A Manger  ,2.75,  ,  ,  ,550.97, restaurants, 
28-Nov-18, Chiltern Firehouse  ,25.3,  ,  ,  ,553.72, restaurants, 
28-Nov-18, Sunflower Cafe  ,10.95,  ,  ,  ,579.02, restaurants, 
28-Nov-18, Sainsbury's  ,4.5,  ,  ,  ,589.97, groceries, 
27-Nov-18, To Holidays   ,0.66,  ,  ,  ,594.47, transfers, 
27-Nov-18, To Holidays   ,1.5,  ,  ,  ,595.13, transfers, 
27-Nov-18, Exchange  to GBP FX Rate £1 = €1.1270 ,  ,443.63,  EUR 500.00 ,  ,596.63, general, 
27-Nov-18, Pret A Manger  ,4.48,  ,  ,  ,153, restaurants, 
27-Nov-18, Ms To Go Ssp Ltd  ,3,  ,  ,  ,157.48, groceries, 
27-Nov-18, Buongiorno e Buonasera  ,29.5,  ,  ,  ,160.48, restaurants, 
27-Nov-18, Starbucks Coffee  ,2.75,  ,  ,  ,189.98, restaurants, 
27-Nov-18, To Holidays   ,0.4,  ,  ,  ,192.73, transfers, 
27-Nov-18, Transport for London  ,4.8,  ,  ,  ,193.13, transport, 
26-Nov-18, Transport for London  ,4.8,  ,  ,  ,197.93, transport, 
26-Nov-18, Starbucks Coffee  ,2.75,  ,  ,  ,202.73, restaurants, 
26-Nov-18, Nyx healthyvendingco  ,1.2,  ,  ,  ,205.48, groceries, 
26-Nov-18, Nyx healthyvendingco  ,1.2,  ,  ,  ,206.68, groceries, 
26-Nov-18, To Holidays   ,0.1,  ,  ,  ,207.88, transfers, 
26-Nov-18, To Holidays   ,0.5,  ,  ,  ,207.98, transfers, 
25-Nov-18, To Holidays   ,1.4,  ,  ,  ,208.48, transfers, 
25-Nov-18, To Holidays   ,1,  ,  ,  ,209.88, transfers, 
25-Nov-18, To Holidays   ,0.5,  ,  ,  ,210.88, transfers, 
25-Nov-18, To Holidays   ,1.04,  ,  ,  ,211.38, transfers, 
25-Nov-18, To Holidays   ,2,  ,  ,  ,212.42, transfers, 
25-Nov-18, Marylebone  ,2.6,  ,  ,  ,214.42, restaurants, 
25-Nov-18, UoW  ,3.6,  ,  ,  ,217.02, restaurants, 
25-Nov-18, Sainsbury's  ,11.3,  ,  ,  ,220.62, groceries, 
24-Nov-18, From Holidays   ,  ,3.7,  ,  ,231.92, transfers, 
24-Nov-18, Payment from L Maresca  ,  ,38.11,  ,  ,228.22, general, MONEY TRANSFER
24-Nov-18, To Holidays   ,0.5,  ,  ,  ,190.11, transfers, 
24-Nov-18, To Holidays   ,1.6,  ,  ,  ,190.61, transfers, 
24-Nov-18, To Holidays   ,1.6,  ,  ,  ,192.21, transfers, 
24-Nov-18, From Holidays   ,  ,109.75,  ,  ,193.81, transfers, 
24-Nov-18, Pret A Manger  ,2.75,  ,  ,  ,84.06, restaurants, 
24-Nov-18, Sunflower Cafe  ,10.5,  ,  ,  ,86.81, restaurants, 
23-Nov-18, To Holidays   ,1.4,  ,  ,  ,97.31, transfers, 
23-Nov-18, To Holidays   ,0.8,  ,  ,  ,98.71, transfers, 
23-Nov-18, To Holidays   ,0.8,  ,  ,  ,99.51, transfers, 
23-Nov-18, Chef Academy London  ,2,  ,  ,  ,100.31, restaurants, 
23-Nov-18, To Holidays   ,1.2,  ,  ,  ,102.31, transfers, 
23-Nov-18, Transport for London  ,2.4,  ,  ,  ,103.51, transport, 
23-Nov-18, Sunflower Cafe  ,8.5,  ,  ,  ,105.91, restaurants, 
23-Nov-18, Transport for London  ,5.3,  ,  ,  ,114.41, transport, 
23-Nov-18, Pret A Manger  ,2.75,  ,  ,  ,119.71, restaurants, 
22-Nov-18, To Holidays   ,1,  ,  ,  ,122.46, transfers, 
22-Nov-18, To Holidays   ,0.5,  ,  ,  ,123.46, transfers, 
22-Nov-18, Sunflower Cafe  ,8.5,  ,  ,  ,123.96, restaurants, 
22-Nov-18, Barber and Parlour  ,10.13,  ,  ,  ,132.46, restaurants, 
22-Nov-18, Barber and Parlour  ,16,  ,  ,  ,142.59, restaurants, 
22-Nov-18, To Holidays   ,1.4,  ,  ,  ,158.59, transfers, 
21-Nov-18, To Holidays   ,2,  ,  ,  ,159.99, transfers, 
21-Nov-18, To Holidays   ,1,  ,  ,  ,161.99, transfers, 
21-Nov-18, Park Plaza Sherlock Holmes London  ,2.2,  ,  ,  ,162.99, restaurants, 
21-Nov-18, Tesco Superstore  ,9.8,  ,  ,  ,165.19, groceries, 
21-Nov-18, Electric Shoreditch  ,38,  ,  ,  ,174.99, entertainment, 
21-Nov-18, UoW  ,4.7,  ,  ,  ,212.99, restaurants, 
21-Nov-18, Marylebone  ,4.55,  ,  ,  ,217.69, restaurants, 
21-Nov-18, To Holidays   ,0.4,  ,  ,  ,222.24, transfers, 
21-Nov-18, Transport for London  ,4.8,  ,  ,  ,222.64, transport, 
21-Nov-18, To Holidays   ,0.5,  ,  ,  ,227.44, transfers, 
20-Nov-18, To Holidays   ,1.74,  ,  ,  ,227.94, transfers, 
20-Nov-18, To Holidays   ,2,  ,  ,  ,229.68, transfers, 
20-Nov-18, To Luca Mircoli  ,20,  ,  ,  ,231.68, transfers, 
20-Nov-18, To Holidays   ,1,  ,  ,  ,251.68, transfers, 
20-Nov-18, To Holidays   ,0.4,  ,  ,  ,252.68, transfers, 
20-Nov-18, Transport for London  ,4.8,  ,  ,  ,253.08, transport, 
20-Nov-18, Sainsbury's  ,11.45,  ,  ,  ,257.88, groceries, 
20-Nov-18, To Holidays   ,2,  ,  ,  ,269.33, transfers, 
19-Nov-18, To Holidays   ,0.4,  ,  ,  ,271.33, transfers, 
19-Nov-18, Transport for London  ,6.3,  ,  ,  ,271.73, transport, 
19-Nov-18, taste Festivals Limit  ,1,  ,  ,  ,278.03, entertainment, 
19-Nov-18, Ms To Go Ssp Ltd  ,3,  ,  ,  ,279.03, groceries, 
19-Nov-18, The Japanese Canteen  ,13.41,  ,  ,  ,282.03, restaurants, 
19-Nov-18, To Holidays   ,1.6,  ,  ,  ,295.44, transfers, 
19-Nov-18, To Holidays   ,0.6,  ,  ,  ,297.04, transfers, 
19-Nov-18, To Holidays   ,0.9,  ,  ,  ,297.64, transfers, 
18-Nov-18, To Holidays   ,1.1,  ,  ,  ,298.54, transfers, 
18-Nov-18, UoW  ,2.95,  ,  ,  ,299.64, restaurants, 
18-Nov-18, To Holidays   ,1.4,  ,  ,  ,302.59, transfers, 
18-Nov-18, Transport for London  ,5.3,  ,  ,  ,303.99, transport, 
18-Nov-18, Park Plaza Sherlock Holmes London  ,4.4,  ,  ,  ,309.29, restaurants, 
18-Nov-18, To Holidays   ,1.4,  ,  ,  ,313.69, transfers, 
17-Nov-18, To Holidays   ,1.18,  ,  ,  ,315.09, transfers, 
17-Nov-18, To Holidays   ,2,  ,  ,  ,316.27, transfers, 
17-Nov-18, Payment from L Maresca  ,  ,150,  ,  ,318.27, general, MONEY TRANSFER
17-Nov-18, To Holidays   ,2,  ,  ,  ,168.27, transfers, 
17-Nov-18, Exchange  to GBP FX Rate £1 = €1.1294 ,  ,4.06,  EUR 4.59 ,  ,170.27, general, 
17-Nov-18, To Holidays   ,0.4,  ,  ,  ,166.21, transfers, 
17-Nov-18, Transport for London  ,5.8,  ,  ,  ,166.61, transport, 
17-Nov-18, Tesco Superstore  ,10.7,  ,  ,  ,172.41, groceries, 
17-Nov-18, Newsmart  ,9,  ,  ,  ,183.11, shopping, 
17-Nov-18, Tesco Superstore  ,16.78,  ,  ,  ,192.11, groceries, 
17-Nov-18, Sunflower Cafe  ,8.5,  ,  ,  ,208.89, restaurants, 
17-Nov-18, Pret A Manger  ,2.75,  ,  ,  ,217.39, restaurants, 
16-Nov-18, To Holidays   ,0.1,  ,  ,  ,220.14, transfers, 
16-Nov-18, To Holidays   ,1.2,  ,  ,  ,220.24, transfers, 
16-Nov-18, Tesco Superstore  ,1.75,  ,  ,  ,221.44, groceries, 
16-Nov-18, Pret A Manger  ,2.75,  ,  ,  ,223.19, restaurants, 
16-Nov-18, Island Poke  ,8.85,  ,  ,  ,225.94, restaurants, 
15-Nov-18, To Holidays   ,0.44,  ,  ,  ,234.79, transfers, 
15-Nov-18, To Holidays   ,0.6,  ,  ,  ,235.23, transfers, 
15-Nov-18, To Holidays   ,1,  ,  ,  ,235.83, transfers, 
15-Nov-18, To Holidays   ,0.5,  ,  ,  ,236.83, transfers, 
15-Nov-18, To Holidays   ,2,  ,  ,  ,237.33, transfers, 
15-Nov-18, Tesco Superstore  ,9.72,  ,  ,  ,239.33, groceries, 
15-Nov-18, Gitane  ,19.5,  ,  ,  ,249.05, restaurants, 
15-Nov-18, The Hummingbird Bakery  ,4.45,  ,  ,  ,268.55, groceries, 
15-Nov-18, Transport for London  ,2.4,  ,  ,  ,273, transport, 
15-Nov-18, Npower  ,51.75,  ,  ,  ,275.4, utilities, 
14-Nov-18, To Holidays   ,0.5,  ,  ,  ,327.15, transfers, 
14-Nov-18, Ryanair FX Rate £1 = €1.1444 ,4.81,  ,  EUR 5.50 ,  ,327.65, travel, 
14-Nov-18, To Holidays   ,0.3,  ,  ,  ,332.46, transfers, 
14-Nov-18, To Holidays   ,0.5,  ,  ,  ,332.76, transfers, 
14-Nov-18, To Holidays   ,1.2,  ,  ,  ,333.26, transfers, 
13-Nov-18, To Holidays   ,0.56,  ,  ,  ,334.46, transfers, 
13-Nov-18, To Holidays   ,1,  ,  ,  ,335.02, transfers, 
13-Nov-18, To Holidays   ,0.5,  ,  ,  ,336.02, transfers, 
13-Nov-18, To Holidays   ,1.1,  ,  ,  ,336.52, transfers, 
12-Nov-18, To Holidays   ,0.38,  ,  ,  ,337.62, transfers, 
12-Nov-18, Exchange GBP to  FX Rate £1 = €1.1446 ,20,  ,  GBP 20.00 ,  ,338, general, 
11-Nov-18, From Gianluigi Coccia  ,  ,43,  ,  ,358, transfers, Resto cleaner
11-Nov-18, Exchange GBP to  FX Rate £1 = €1.1386 ,50,  ,  GBP 50.00 ,  ,315, general, 
11-Nov-18, From Luca Mircoli  ,  ,365,  ,  ,365, transfers, 
11-Nov-18, Cash at Sainsbury's Bank Fee: 0.61 ,60.61,  ,  ,  ,0, cash, 
11-Nov-18, Greater Anglia  ,29,  ,  ,  ,60.61, transport, 
10-Nov-18, Exchange GBP to  FX Rate £1 = €1.1386 ,27.55,  ,  GBP 27.55 ,  ,89.61, general, 
10-Nov-18, Cash at Royal Bank of Scotland  ,20,  ,  ,  ,117.16, cash, 
10-Nov-18, Lexington Catering  ,1.75,  ,  ,  ,137.16, restaurants, 
10-Nov-18, Deliveroo  ,13.57,  ,  ,  ,138.91, groceries, 
10-Nov-18, Sunflower Cafe  ,8,  ,  ,  ,152.48, restaurants, 
10-Nov-18, From Gianluigi Coccia  ,  ,20,  ,  ,160.48, transfers, Cleaner 20/63
09-Nov-18, To Holidays   ,2,  ,  ,  ,140.48, transfers, 
09-Nov-18, To Holidays   ,50,  ,  ,  ,142.48, transfers, 
09-Nov-18, Netflix HQ  ,9.99,  ,  ,  ,192.48, utilities, 
09-Nov-18, Pret A Manger  ,2.75,  ,  ,  ,202.47, restaurants, 
09-Nov-18, To Holidays   ,0.4,  ,  ,  ,205.22, transfers, 
09-Nov-18, Transport for London  ,5.8,  ,  ,  ,205.62, transport, 
09-Nov-18, Tesco Superstore  ,5.6,  ,  ,  ,211.42, groceries, 
09-Nov-18, Sunflower Cafe  ,8.5,  ,  ,  ,217.02, restaurants, 
08-Nov-18, To Holidays   ,0.86,  ,  ,  ,225.52, transfers, 
08-Nov-18, To Holidays   ,0.5,  ,  ,  ,226.38, transfers, 
08-Nov-18, To Holidays   ,2,  ,  ,  ,226.88, transfers, 
08-Nov-18, Transport for London  ,5.8,  ,  ,  ,228.88, transport, 
08-Nov-18, Sunflower Cafe  ,8.5,  ,  ,  ,234.68, restaurants, 
08-Nov-18, Boots  ,11.88,  ,  ,  ,243.18, health, 
07-Nov-18, From Luca Mircoli  ,  ,10,  ,  ,255.06, transfers, 
07-Nov-18, To Holidays   ,0.8,  ,  ,  ,245.06, transfers, 
07-Nov-18, To Holidays   ,1,  ,  ,  ,245.86, transfers, 
07-Nov-18, Tesco Stores Ltd  ,0.89,  ,  ,  ,246.86, groceries, 
07-Nov-18, Sunflower Cafe  ,17,  ,  ,  ,247.75, restaurants, 
07-Nov-18, To Holidays   ,0.5,  ,  ,  ,264.75, transfers, 
07-Nov-18, To Holidays   ,0.02,  ,  ,  ,265.25, transfers, 
07-Nov-18, To Holidays   ,0.4,  ,  ,  ,265.27, transfers, 
07-Nov-18, To Christopher Maclean  ,60,  ,  ,  ,265.67, transfers, month of November
06-Nov-18, From Luca Mircoli  ,  ,10,  ,  ,325.67, transfers, 
06-Nov-18, To Holidays   ,0.24,  ,  ,  ,315.67, transfers, 
06-Nov-18, To Holidays   ,1,  ,  ,  ,315.91, transfers, 
06-Nov-18, To Holidays   ,0.22,  ,  ,  ,316.91, transfers, 
05-Nov-18, From Luca Mircoli  ,  ,300,  ,  ,317.13, transfers, 
04-Nov-18, From Holidays   ,  ,6.86,  ,  ,17.13, transfers, 
04-Nov-18, From Gianluigi Coccia  ,  ,10,  ,  ,10.27, transfers, 
02-Nov-18, Alfred Dunhill Ltd  ,24,  ,  ,  ,0.27, shopping, 
01-Nov-18, To Lorenz Maresca  ,45,  ,  ,  ,24.27, transfers, 
01-Nov-18, To Christopher Maclean  ,1,,,,,,
01-Nov-18, Wasabi  ,16.75,  ,  ,  ,1,,
01-Nov-18, Waterstones  ,10.12,  ,  ,  ,1,,
01-Nov-18, Payment from L Maresca  ,  ,660,  ,  ,1,,
31-Oct-18, To Holidays   ,2,  ,  ,  ,736.14, transfers, 
31-Oct-18, To Holidays   ,1.4,  ,  ,  ,738.14, transfers, 
31-Oct-18, Transport for London  ,5.3,  ,  ,  ,739.54, transport, 
30-Oct-18, To Holidays   ,0.5,  ,  ,  ,744.84, transfers, 
30-Oct-18, To Holidays   ,1.76,  ,  ,  ,745.34, transfers, 
30-Oct-18, Exchange  to GBP FX Rate £1 = €1.1237 ,  ,711.92,  EUR 800.00 ,  ,747.1, general, 
29-Oct-18, To Luca Mircoli  ,0.1,  ,  ,  ,35.18, transfers, 
28-Oct-18, From Gianluigi Coccia  ,  ,20,  ,  ,35.28, transfers, Pizza oregano
25-Oct-18, From Luca Mircoli  ,  ,10,  ,  ,15.28, transfers, 
25-Oct-18, Transport for London  ,2.4,  ,  ,  ,5.28, transport, 
24-Oct-18, To Holidays   ,1.2,  ,  ,  ,7.68, transfers, 
23-Oct-18, Birmingham Coach Station  ,14,  ,  ,  ,8.88, transport, 
23-Oct-18, The Perseverance  ,5.1,  ,  ,  ,22.88, restaurants, 
22-Oct-18, Exchange GBP to  FX Rate £1 = €1.1293 ,1,  ,  GBP 1.00 ,  ,27.98, general, 
22-Oct-18, From Holidays   ,  ,9.41,  ,  ,28.98, transfers, 
22-Oct-18, Exchange GBP to  FX Rate £1 = €1.1324 ,35,  ,  GBP 35.00 ,  ,19.57, general, 
21-Oct-18, Exchange GBP to  FX Rate £1 = €1.1273 ,65,  ,  GBP 65.00 ,  ,54.57, general, 
21-Oct-18, Payment from L Maresca  ,  ,100,  ,  ,119.57, general, MONEY TRANSFER
20-Oct-18, Island Poke  ,20.3,  ,  ,  ,19.57, restaurants, 
19-Oct-18, Exchange GBP to  FX Rate £1 = €1.1374 ,126,  ,  GBP 126.00 ,  ,39.87, general, 
19-Oct-18, Payment from L Maresca  ,  ,100,  ,  ,165.87, general, MONEY TRANSFER
19-Oct-18, To Holidays   ,2,  ,  ,  ,65.87, transfers, 
18-Oct-18, From Luca Mircoli  ,  ,30,  ,  ,67.87, transfers, 
18-Oct-18, To Holidays   ,1.8,  ,  ,  ,37.87, transfers, 
18-Oct-18, To Holidays   ,1.4,  ,  ,  ,39.67, transfers, 
18-Oct-18, Sunflower Cafe  ,8,  ,  ,  ,41.07, restaurants, 
18-Oct-18, Chef Academy London  ,6.2,  ,  ,  ,49.07, restaurants, 
18-Oct-18, Pret A Manger  ,2.75,  ,  ,  ,55.27, restaurants, 
17-Oct-18, From Holidays   ,  ,10,  ,  ,58.02, transfers, 
17-Oct-18, Waitrose  ,8.25,  ,  ,  ,48.02, groceries, 
17-Oct-18, Waitrose  ,6.99,  ,  ,  ,56.27, groceries, 
17-Oct-18, Sunflower Cafe  ,1.5,  ,  ,  ,63.26, restaurants, 
17-Oct-18, Sunflower Cafe  ,7,  ,  ,  ,64.76, restaurants, 
16-Oct-18, To Holidays   ,1.6,  ,  ,  ,71.76, transfers, 
16-Oct-18, To Holidays   ,2,  ,  ,  ,73.36, transfers, 
16-Oct-18, Todich Floral Design - London florist  ,4,  ,  ,  ,75.36, shopping, 
16-Oct-18, To Holidays   ,0.5,  ,  ,  ,79.36, transfers, 
15-Oct-18, To Holidays   ,1,  ,  ,  ,79.86, transfers, 
15-Oct-18, To Holidays   ,2,  ,  ,  ,80.86, transfers, 
14-Oct-18, To Holidays   ,2,  ,  ,  ,82.86, transfers, 
14-Oct-18, To Holidays   ,1.5,  ,  ,  ,84.86, transfers, 
14-Oct-18, To Holidays   ,0.02,  ,  ,  ,86.36, transfers, 
14-Oct-18, From Luca Mircoli  ,  ,15,  ,  ,86.38, transfers, 
14-Oct-18, Planet Organic  ,4.5,  ,  ,  ,71.38, groceries, 
14-Oct-18, The Mandrake Hotel  ,50.63,  ,  ,  ,75.88, travel, 
14-Oct-18, Patty & Bun  ,15,  ,  ,  ,126.51, restaurants, 
14-Oct-18, The Hummingbird Bakery  ,4.5,  ,  ,  ,141.51, groceries, 
14-Oct-18, Hillman Butchers  ,8.49,  ,  ,  ,146.01, groceries, 
13-Oct-18, From Holidays   ,  ,10,  ,  ,154.5, transfers, 
13-Oct-18, Island Poke  ,12.35,  ,  ,  ,144.5, restaurants, 
13-Oct-18, Sainsbury's  ,7.55,  ,  ,  ,156.85, groceries, 
13-Oct-18, Sainsbury's  ,7,  ,  ,  ,164.4, groceries, 
13-Oct-18, Boyle Dry Cleaning  ,4.95,  ,  ,  ,171.4, services, 
12-Oct-18, To Holidays   ,2,  ,  ,  ,176.35, transfers, 
12-Oct-18, To Holidays   ,0.74,  ,  ,  ,178.35, transfers, 
12-Oct-18, To Holidays   ,1,  ,  ,  ,179.09, transfers, 
12-Oct-18, To Holidays   ,1.02,  ,  ,  ,180.09, transfers, 
12-Oct-18, To Holidays   ,1,  ,  ,  ,181.11, transfers, 
12-Oct-18, PureGym York  ,9.99,  ,  ,  ,182.11, entertainment, 
11-Oct-18, To Holidays   ,2,  ,  ,  ,192.1, transfers, 
11-Oct-18, To Holidays   ,0.9,  ,  ,  ,194.1, transfers, 
11-Oct-18, To Holidays   ,0.1,  ,  ,  ,195, transfers, 
11-Oct-18, To Holidays   ,1.3,  ,  ,  ,195.1, transfers, 
11-Oct-18, To Lorenz Maresca  ,675,  ,  ,  ,196.4, transfers, 
11-Oct-18, From Luca Mircoli  ,  ,720,  ,  ,871.4, transfers, Devi morí
11-Oct-18, Co-op Food - Strand  ,17.38,  ,  ,  ,151.4, groceries, 
11-Oct-18, Sainsbury's  ,28.9,  ,  ,  ,168.78, groceries, 
10-Oct-18, To Holidays   ,0.02,  ,  ,  ,197.68, transfers, 
10-Oct-18, From Holidays   ,  ,81.53,  ,  ,197.7, transfers, 
09-Oct-18, To Holidays   ,0.2,  ,  ,  ,116.17, transfers, 
09-Oct-18, To Holidays   ,50,  ,  ,  ,116.37, transfers, 
09-Oct-18, Cash at Sainsbury's Bank Fee: 0.36 ,140.36,  ,  ,  ,166.37, cash, 
09-Oct-18, Trainline  ,53,  ,  ,  ,306.73, transport, 
09-Oct-18, Burger & Lobster  ,63.9,  ,  ,  ,359.73, restaurants, 
09-Oct-18, Cycle Surgery  ,40,  ,  ,  ,423.63, shopping, 
09-Oct-18, Comptoir Libanais Oxford Street  ,34.7,  ,  ,  ,463.63, restaurants, 
09-Oct-18, Starbucks  ,8.39,  ,  ,  ,498.33, restaurants, 
08-Oct-18, To Holidays   ,1.24,  ,  ,  ,506.72, transfers, 
08-Oct-18, Payment from Kamenskikh K  ,  ,26.5,  ,  ,507.96, general, OXFORD
08-Oct-18, Todich Floral Design - London florist  ,12.5,  ,  ,  ,481.46, shopping, 
08-Oct-18, Boots  ,13.99,  ,  ,  ,493.96, health, 
08-Oct-18, Tesco Superstore  ,11.17,  ,  ,  ,507.95, groceries, 
08-Oct-18, Trainline  ,41.6,  ,  ,  ,519.12, transport, 
08-Oct-18, Uber Eats  ,12.49,  ,  ,  ,560.72, transport, 
08-Oct-18, Sainsbury's  ,11,  ,  ,  ,573.21, groceries, 
08-Oct-18, To Holidays   ,1.2,  ,  ,  ,584.21, transfers, 
08-Oct-18, Transport for London  ,2.4,  ,  ,  ,585.41, transport, 
08-Oct-18, Netflix HQ  ,9.99,  ,  ,  ,587.81, utilities, 
07-Oct-18, To Holidays   ,2,  ,  ,  ,597.8, transfers, 
07-Oct-18, To Holidays   ,0.6,  ,  ,  ,599.8, transfers, 
07-Oct-18, To Holidays   ,2,  ,  ,  ,600.4, transfers, 
07-Oct-18, To Holidays   ,1.22,  ,  ,  ,602.4, transfers, 
07-Oct-18, The Court  ,16.99,  ,  ,  ,603.62, restaurants, 
07-Oct-18, To Holidays   ,0.2,  ,  ,  ,620.61, transfers, 
07-Oct-18, Transport for London  ,2.9,  ,  ,  ,620.81, transport, 
07-Oct-18, Tesco Superstore  ,7.25,  ,  ,  ,623.71, transport, 
07-Oct-18, Park Plaza Sherlock Holmes London  ,11.34,  ,  ,  ,630.96, restaurants, 
07-Oct-18, Park Plaza Sherlock Holmes London  ,3.6,  ,  ,  ,642.3, restaurants, 
07-Oct-18, To Holidays   ,0.02,  ,  ,  ,645.9, transfers, 
07-Oct-18, To Holidays   ,2,  ,  ,  ,645.92, transfers, 
06-Oct-18, To Holidays   ,1.02,  ,  ,  ,647.92, transfers, 
06-Oct-18, To Holidays   ,2,  ,  ,  ,648.94, transfers, 
06-Oct-18, To Holidays   ,0.2,  ,  ,  ,650.94, transfers, 
06-Oct-18, To Holidays   ,0.02,  ,  ,  ,651.14, transfers, 
06-Oct-18, To Holidays   ,1.66,  ,  ,  ,651.16, transfers, 
06-Oct-18, To Holidays   ,1,  ,  ,  ,652.82, transfers, 
06-Oct-18, Purl London  ,81,  ,  ,  ,653.82, restaurants, 
06-Oct-18, Park Plaza Sherlock Holmes London  ,9.64,  ,  ,  ,734.82, restaurants, 
06-Oct-18, Park Plaza Sherlock Holmes London  ,4.5,  ,  ,  ,744.46, restaurants, 
05-Oct-18, To Holidays   ,1.5,  ,  ,  ,748.96, transfers, 
05-Oct-18, Exchange  to GBP FX Rate £1 = €1.1377 ,  ,439.48,  EUR 500.00 ,  ,750.46, general, 
05-Oct-18, To Holidays   ,0.8,  ,  ,  ,310.98, transfers, 
05-Oct-18, To Holidays   ,0.02,  ,  ,  ,311.78, transfers, 
05-Oct-18, To Holidays   ,1.32,  ,  ,  ,311.8, transfers, 
05-Oct-18, Park Plaza Sherlock Holmes London  ,2.8,  ,  ,  ,313.12, restaurants, 
05-Oct-18, To Holidays   ,0.8,  ,  ,  ,315.92, transfers, 
04-Oct-18, To Holidays   ,0.72,  ,  ,  ,316.72, transfers, 
04-Oct-18, To Holidays   ,1,  ,  ,  ,317.44, transfers, 
04-Oct-18, Transport for London  ,1.5,  ,  ,  ,318.44, transport, 
04-Oct-18, Darcie & May Green  ,6.25,  ,  ,  ,319.94, restaurants, 
04-Oct-18, To Holidays   ,1,  ,  ,  ,326.19, transfers, 
03-Oct-18, To Holidays   ,2,  ,  ,  ,327.19, transfers, 
03-Oct-18, To Holidays   ,0.4,  ,  ,  ,329.19, transfers, 
03-Oct-18, Marylebone  ,5.55,  ,  ,  ,329.59, restaurants, 
03-Oct-18, To Holidays   ,0.4,  ,  ,  ,335.14, transfers, 
03-Oct-18, Transport for London  ,6.8,  ,  ,  ,335.54, transport, 
03-Oct-18, Fierce Grace  ,42.4,  ,  ,  ,342.34, health, 
02-Oct-18, To Holidays   ,1.5,  ,  ,  ,384.74, transfers, 
02-Oct-18, Transport for London  ,1.5,  ,  ,  ,386.24, transport, 
01-Oct-18, To Holidays   ,1.2,  ,  ,  ,387.74, transfers, 
01-Oct-18, To Holidays   ,0.9,  ,  ,  ,388.94, transfers, 
01-Oct-18, To Christopher Maclean  ,1,,,,,,
01-Oct-18, Exchange  to GBP FX Rate £1 = €1.1250 ,  ,1,,,,,
30-Sep-18, To Holidays   ,1,  ,  ,  ,12.12, transfers, 
23-Sep-18, From Luca Mircoli  ,  ,10,  ,  ,13.12, transfers, 
22-Sep-18, Cash at London Diving Centre  ,20,  ,  ,  ,3.12, cash, 
22-Sep-18, TortelliniCup London  ,10.2,  ,  ,  ,23.12, restaurants, 
22-Sep-18, Sainsbury's  ,14.65,  ,  ,  ,33.32, groceries, 
20-Sep-18, From Holidays   ,  ,5,  ,  ,47.97, transfers, 
20-Sep-18, To Holidays   ,0.7,  ,  ,  ,42.97, transfers, 
20-Sep-18, To Holidays   ,1.6,  ,  ,  ,43.67, transfers, 
20-Sep-18, To Holidays   ,1.2,  ,  ,  ,45.27, transfers, 
20-Sep-18, Transport for London  ,2.4,  ,  ,  ,46.47, transport, 
20-Sep-18, Birleys Sandwiches  ,15.5,  ,  ,  ,48.87, restaurants, 
20-Sep-18, Sainsbury's  ,17.85,  ,  ,  ,64.37, groceries, 
18-Sep-18, To Holidays   ,0.3,  ,  ,  ,82.22, transfers, 
18-Sep-18, From Luca Mircoli  ,  ,8,  ,  ,82.52, transfers, 
18-Sep-18, To Holidays   ,1,  ,  ,  ,74.52, transfers, 
18-Sep-18, Can Can Brasserie  ,17.07,  ,  ,  ,75.52, restaurants, 
18-Sep-18, Tesco Superstore  ,12.18,  ,  ,  ,92.59, groceries, 
17-Sep-18, Meat and Shake  ,5.75,  ,  ,  ,104.77, restaurants, 
17-Sep-18, Café Nespresso  ,2,  ,  ,  ,110.52, restaurants, 
17-Sep-18, Kiehl?s Since 1851  ,49.5,  ,  ,  ,112.52, health, 
17-Sep-18, Tesco Express  ,6.5,  ,  ,  ,162.02, groceries, 
16-Sep-18, From Holidays   ,  ,75,  ,  ,168.52, transfers, 
16-Sep-18, Cash at Po Mill Lane 2221  ,40,  ,  ,  ,93.52, cash, 
16-Sep-18, To Holidays   ,1.2,  ,  ,  ,133.52, transfers, 
16-Sep-18, Transport for London  ,2.4,  ,  ,  ,134.72, transport, 
16-Sep-18, The Hummingbird Bakery  ,7.35,  ,  ,  ,137.12, groceries, 
16-Sep-18, The Japanese Canteen  ,20.52,  ,  ,  ,144.47, restaurants, 
15-Sep-18, To Holidays   ,1,  ,  ,  ,164.99, transfers, 
15-Sep-18, To Holidays   ,1.86,  ,  ,  ,165.99, transfers, 
15-Sep-18, To Holidays   ,1,  ,  ,  ,167.85, transfers, 
15-Sep-18, To Holidays   ,0.5,  ,  ,  ,168.85, transfers, 
15-Sep-18, To Holidays   ,2,  ,  ,  ,169.35, transfers, 
14-Sep-18, Exchange  to GBP FX Rate £1 = €1.1240 ,  ,102.95,  EUR 115.73 ,  ,171.35, general, 
14-Sep-18, To Holidays   ,1.3,  ,  ,  ,68.4, transfers, 
14-Sep-18, Transport for London  ,2.9,  ,  ,  ,69.7, transport, 
14-Sep-18, To Luca Mircoli  ,11,  ,  ,  ,72.6, transfers, 
14-Sep-18, To Luca Mircoli  ,10,  ,  ,  ,83.6, transfers, 
14-Sep-18, Exchange  to GBP FX Rate £1 = €1.1221 ,  ,89.11,  EUR 100.00 ,  ,93.6, general, 
13-Sep-18, To Holidays   ,0.2,  ,  ,  ,4.49, transfers, 
04-Sep-18, Boulestine  ,35,  ,  ,  ,4.69, restaurants, 
04-Sep-18, Boots  ,8.5,  ,  ,  ,39.69, health, 
04-Sep-18, Tesco Superstore  ,9.45,  ,  ,  ,48.19, groceries, 
03-Sep-18, From Luca Mircoli  ,  ,4,  ,  ,57.64, transfers, 
03-Sep-18, Patisserie Valerie  ,2,  ,  ,  ,53.64, restaurants, 
03-Sep-18, Princi  ,30.2,  ,  ,  ,55.64, restaurants, 
02-Sep-18, To Holidays   ,1,  ,  ,  ,85.84, transfers, 
02-Sep-18, Planet Organic  ,4.5,  ,  ,  ,86.84, groceries, 
01-Sep-18, To Holidays   ,1.1,  ,  ,  ,91.34, transfers, 
01-Sep-18, To Holidays   ,2,  ,  ,  ,92.44, transfers, 
01-Sep-18, To Holidays   ,2,  ,  ,  ,94.44, transfers, 
31-Aug-18, To Holidays   ,1.6,  ,  ,  ,96.44, transfers, 
31-Aug-18, Exchange  to GBP FX Rate £1 = €1.1167 ,  ,89.54,  EUR 100.00 ,  ,98.04, general, 
31-Aug-18, To Holidays   ,1,  ,  ,  ,8.5, transfers, 
28-Aug-18, Uber Greenlight  ,5,  ,  ,  ,9.5, transport, 
27-Aug-18, Uber Eats  ,17.47,  ,  ,  ,14.5, transport, 
26-Aug-18, To Holidays   ,2,  ,  ,  ,31.97, transfers, 
25-Aug-18, To Holidays   ,1.06,  ,  ,  ,33.97, transfers, 
25-Aug-18, Payment from S Migliorin  ,  ,35,  ,  ,35.03, general, FANCULO AHAH
20-Aug-18, Deutsche Bank  ,0.85,  ,  ,  ,0.03, groceries, 
20-Aug-18, Caffè Nero  ,1.85,  ,  ,  ,0.88, restaurants, 
20-Aug-18, Birleys Sandwiches  ,4,  ,  ,  ,2.73, restaurants, 
19-Aug-18, Wasabi Sushi & Bento  ,18.8,  ,  ,  ,6.73, restaurants, 
19-Aug-18, Wasabi Sushi & Bento  ,10.2,  ,  ,  ,25.53, restaurants, 
19-Aug-18, Deutsche Bank  ,2.9,  ,  ,  ,35.73, restaurants, 
19-Aug-18, Deutsche Bank  ,3,  ,  ,  ,38.63, restaurants, 
18-Aug-18, Cash at Kilburn Ug Station  ,10,  ,  ,  ,41.63, cash, 
18-Aug-18, Uber Eats  ,14.95,  ,  ,  ,51.63, transport, 
18-Aug-18, The Mandrake Hotel  ,99.56,  ,  ,  ,66.58, travel, 
18-Aug-18, Paul Smith Avery Row  ,29,  ,  ,  ,166.14, shopping, 
18-Aug-18, itsu  ,0.99,  ,  ,  ,195.14, restaurants, 
18-Aug-18, Sainsbury's Local  ,13.95,  ,  ,  ,196.13, groceries, 
18-Aug-18, Sainsbury's Local  ,14,  ,  ,  ,210.08, groceries, 
14-Aug-18, To Holidays   ,0.3,  ,  ,  ,224.08, transfers, 
14-Aug-18, To Holidays   ,2,  ,  ,  ,224.38, transfers, 
13-Aug-18, To Holidays   ,0.4,  ,  ,  ,226.38, transfers, 
13-Aug-18, To Holidays   ,2,  ,  ,  ,226.78, transfers, 
13-Aug-18, To Holidays   ,0.2,  ,  ,  ,228.78, transfers, 
13-Aug-18, To Holidays   ,1.6,  ,  ,  ,228.98, transfers, 
12-Aug-18, To Holidays   ,0.1,  ,  ,  ,230.58, transfers, 
12-Aug-18, To Holidays   ,0.88,  ,  ,  ,230.68, transfers, 
12-Aug-18, From Holidays   ,  ,87.64,  ,  ,231.56, transfers, 
12-Aug-18, Birleys Sandwiches  ,5.3,  ,  ,  ,143.92, restaurants, 
12-Aug-18, Deutsche Bank  ,1.45,  ,  ,  ,149.22, restaurants, 
12-Aug-18, Deutsche Bank  ,1.65,  ,  ,  ,150.67, restaurants, 
12-Aug-18, Pret A Manger  ,6.99,  ,  ,  ,152.32, restaurants, 
12-Aug-18, Caffè Nero  ,2.05,  ,  ,  ,159.31, restaurants, 
12-Aug-18, Uber Eats  ,31.96,  ,  ,  ,161.36, transport, 
12-Aug-18, To Holidays   ,1.4,  ,  ,  ,193.32, transfers, 
12-Aug-18, Transport for London  ,5.3,  ,  ,  ,194.72, transport, 
11-Aug-18, To Holidays   ,2,  ,  ,  ,200.02, transfers, 
11-Aug-18, To Holidays   ,0.1,  ,  ,  ,202.02, transfers, 
11-Aug-18, To Holidays   ,2,  ,  ,  ,202.12, transfers, 
11-Aug-18, To Holidays   ,0.02,  ,  ,  ,204.12, transfers, 
11-Aug-18, Deutsche Bank  ,0.7,  ,  ,  ,204.14, groceries, 
11-Aug-18, Wasabi Sushi & Bento  ,10.1,  ,  ,  ,204.84, restaurants, 
11-Aug-18, South Place Restaurant An  ,225,  ,  ,  ,214.94, restaurants, 
11-Aug-18, Deutsche Bank  ,3.25,  ,  ,  ,439.94, restaurants, 
11-Aug-18, Deutsche Bank  ,4.05,  ,  ,  ,443.19, restaurants, 
11-Aug-18, Deutsche Bank  ,1.45,  ,  ,  ,447.24, restaurants, 
11-Aug-18, To Holidays   ,0.08,  ,  ,  ,448.69, transfers, 
11-Aug-18, To Holidays   ,2,  ,  ,  ,448.77, transfers, 
10-Aug-18, To Holidays   ,1.1,  ,  ,  ,450.77, transfers, 
10-Aug-18, To Holidays   ,1.4,  ,  ,  ,451.87, transfers, 
10-Aug-18, To Holidays   ,1.9,  ,  ,  ,453.27, transfers, 
10-Aug-18, Deutsche Bank  ,0.7,  ,  ,  ,455.17, groceries, 
10-Aug-18, Deutsche Bank  ,6,  ,  ,  ,455.87, restaurants, 
10-Aug-18, Birleys Sandwiches  ,5.65,  ,  ,  ,461.87, restaurants, 
10-Aug-18, Tesco Express  ,1.19,  ,  ,  ,467.52, groceries, 
10-Aug-18, Deutsche Bank  ,3.85,  ,  ,  ,468.71, restaurants, 
10-Aug-18, To Holidays   ,0.7,  ,  ,  ,472.56, transfers, 
10-Aug-18, To Holidays   ,0.02,  ,  ,  ,473.26, transfers, 
09-Aug-18, To Holidays   ,2,  ,  ,  ,473.28, transfers, 
09-Aug-18, To Holidays   ,0.6,  ,  ,  ,475.28, transfers, 
09-Aug-18, To Holidays   ,1.1,  ,  ,  ,475.88, transfers, 
09-Aug-18, To Holidays   ,1.8,  ,  ,  ,476.98, transfers, 
09-Aug-18, To Holidays   ,50,  ,  ,  ,478.78, transfers, 
09-Aug-18, To Holidays   ,1.5,  ,  ,  ,528.78, transfers, 
09-Aug-18, Halfords - Kilburn Store  ,202.95,  ,  ,  ,530.28, transport, 
09-Aug-18, To Holidays   ,1.9,  ,  ,  ,733.23, transfers, 
08-Aug-18, To Holidays   ,1.62,  ,  ,  ,735.13, transfers, 
08-Aug-18, To Holidays   ,0.6,  ,  ,  ,736.75, transfers, 
08-Aug-18, To Gianluigi Coccia  ,1,  ,  ,  ,737.35, transfers, 
08-Aug-18, To Holidays   ,2,  ,  ,  ,738.35, transfers, 
08-Aug-18, To Holidays   ,1.2,  ,  ,  ,740.35, transfers, 
08-Aug-18, Transport for London  ,2.4,  ,  ,  ,741.55, transport, 
08-Aug-18, Hillman Butchers  ,22,  ,  ,  ,743.95, groceries, 
08-Aug-18, Badolina  ,9.7,  ,  ,  ,765.95, restaurants, 
08-Aug-18, Deutsche Bank  ,4.15,  ,  ,  ,775.65, restaurants, 
08-Aug-18, Deutsche Bank  ,4.6,  ,  ,  ,779.8, restaurants, 
08-Aug-18, To Holidays   ,0.3,  ,  ,  ,784.4, transfers, 
08-Aug-18, To Holidays   ,0.7,  ,  ,  ,784.7, transfers, 
07-Aug-18, To Holidays   ,0.1,  ,  ,  ,785.4, transfers, 
07-Aug-18, Exchange  to GBP FX Rate £1 = €1.1173 ,  ,707.04,  EUR 790.00 ,  ,785.5, general, 
07-Aug-18, To Holidays   ,1,  ,  ,  ,78.46, transfers, 
07-Aug-18, Transport for London  ,1.5,  ,  ,  ,79.46, transport, 
06-Aug-18, To Holidays   ,1.4,  ,  ,  ,80.96, transfers, 
06-Aug-18, Transport for London  ,5.3,  ,  ,  ,82.36, transport, 
06-Aug-18, Uber Eats  ,7.57,  ,  ,  ,87.66, transport, 
06-Aug-18, To Holidays   ,1.7,  ,  ,  ,95.23, transfers, 
06-Aug-18, To Holidays   ,0.6,  ,  ,  ,96.93, transfers, 
06-Aug-18, To Holidays   ,0.8,  ,  ,  ,97.53, transfers, 
05-Aug-18, Pret A Manger  ,6.24,  ,  ,  ,98.33, restaurants, 
05-Aug-18, Deutsche Bank  ,1.45,  ,  ,  ,104.57, restaurants, 
04-Aug-18, To Holidays   ,2,  ,  ,  ,106.02, transfers, 
04-Aug-18, To Holidays   ,2,  ,  ,  ,108.02, transfers, 
04-Aug-18, From Holidays   ,  ,99.81,  ,  ,110.02, transfers, 
04-Aug-18, Tesco Express  ,1.35,  ,  ,  ,10.21, groceries, 
04-Aug-18, Piada Bar  ,8,  ,  ,  ,11.56, restaurants, 
04-Aug-18, Deutsche Bank  ,5.35,  ,  ,  ,19.56, restaurants, 
04-Aug-18, Wasabi Sushi & Bento  ,15.8,  ,  ,  ,24.91, restaurants, 
04-Aug-18, Oriole Bar  ,21.38,  ,  ,  ,40.71, restaurants, 
03-Aug-18, To Holidays   ,1.1,  ,  ,  ,62.09, transfers, 
03-Aug-18, Uber Eats  ,21.2,  ,  ,  ,63.19, transport, 
03-Aug-18, Deutsche Bank  ,0.7,  ,  ,  ,84.39, groceries, 
03-Aug-18, Piada Bar  ,8,  ,  ,  ,85.09, restaurants, 
02-Aug-18, To Holidays   ,0.4,  ,  ,  ,93.09, transfers, 
02-Aug-18, To Holidays   ,1.3,  ,  ,  ,93.49, transfers, 
02-Aug-18, To Holidays   ,2,  ,  ,  ,94.79, transfers, 
02-Aug-18, Deutsche Bank  ,1.45,  ,  ,  ,96.79, restaurants, 
02-Aug-18, Deutsche Bank  ,2.7,  ,  ,  ,98.24, restaurants, 
02-Aug-18, To Holidays   ,1.3,  ,  ,  ,100.94, transfers, 
01-Aug-18, To Holidays   ,1.24,  ,  ,  ,102.24, transfers, 
01-Aug-18, To Holidays   ,2,  ,  ,  ,103.48, transfers, 
01-Aug-18, To Holidays   ,0.6,  ,  ,  ,105.48, transfers, 
01-Aug-18, To Holidays   ,0.4,  ,  ,  ,106.08, transfers, 
01-Aug-18, Transport for London  ,6.8,  ,  ,  ,106.48, transport, 
01-Aug-18, Deutsche Bank  ,1.1,  ,  ,  ,113.28, restaurants, 
01-Aug-18, Deutsche Bank  ,1.45,  ,  ,  ,114.38, restaurants, 
01-Aug-18, TortelliniCup London  ,5.5,  ,  ,  ,115.83, restaurants, 
01-Aug-18, Piada Bar  ,8,  ,  ,  ,121.33, restaurants, 
01-Aug-18, Deutsche Bank  ,4.25,  ,  ,  ,129.33, restaurants, 
01-Aug-18, To Holidays   ,2,  ,  ,  ,133.58, transfers, 
31-Jul-18, To Holidays   ,0.6,  ,  ,  ,135.58, transfers, 
31-Jul-18, To Holidays   ,1.1,  ,  ,  ,136.18, transfers, 
30-Jul-18, To Holidays   ,1,  ,  ,  ,137.28, transfers, 
30-Jul-18, Cash at Mantilla Limited - Pm  ,100,  ,  ,  ,138.28, cash, 
30-Jul-18, oaxaca Limited  ,11,  ,  ,  ,238.28, restaurants, 
30-Jul-18, Waitrose  ,87.37,  ,  ,  ,249.28, groceries, 
30-Jul-18, Va Swiss Cottage  ,12,  ,  ,  ,336.65, entertainment, 
30-Jul-18, TortelliniCup London  ,7.9,  ,  ,  ,348.65, restaurants, 
30-Jul-18, Transport for London  ,3.9,  ,  ,  ,356.55, transport, 
30-Jul-18, To Holidays   ,2,  ,  ,  ,360.45, transfers, 
30-Jul-18, To Holidays   ,1.1,  ,  ,  ,362.45, transfers, 
30-Jul-18, To Holidays   ,1.8,  ,  ,  ,363.55, transfers, 
30-Jul-18, To Holidays   ,1.5,  ,  ,  ,365.35, transfers, 
29-Jul-18, Koya City  ,11.8,  ,  ,  ,366.85, restaurants, 
29-Jul-18, Sainsbury's  ,0.55,  ,  ,  ,378.65, groceries, 
29-Jul-18, Sainsbury's  ,13,  ,  ,  ,379.2, groceries, 
29-Jul-18, Uber Eats  ,24.38,  ,  ,  ,392.2, transport, 
29-Jul-18, To Holidays   ,0.4,  ,  ,  ,416.58, transfers, 
29-Jul-18, Transport for London  ,4.8,  ,  ,  ,416.98, transport, 
29-Jul-18, Deutsche Bank  ,1.75,  ,  ,  ,421.78, restaurants, 
29-Jul-18, To Holidays   ,0.2,  ,  ,  ,423.53, transfers, 
29-Jul-18, From Angela Peruffo  ,  ,40,  ,  ,423.73, transfers, 
28-Jul-18, To Holidays   ,1.26,  ,  ,  ,383.73, transfers, 
28-Jul-18, To Holidays   ,2,  ,  ,  ,384.99, transfers, 
28-Jul-18, To Holidays   ,0.2,  ,  ,  ,386.99, transfers, 
28-Jul-18, To Holidays   ,2,  ,  ,  ,387.19, transfers, 
28-Jul-18, To Holidays   ,0.4,  ,  ,  ,389.19, transfers, 
28-Jul-18, Transport for London  ,6.8,  ,  ,  ,389.59, transport, 
28-Jul-18, The Good Yard  ,6.5,  ,  ,  ,396.39, restaurants, 
28-Jul-18, Pret A Manger  ,3.24,  ,  ,  ,402.89, restaurants, 
28-Jul-18, To Holidays   ,1.24,  ,  ,  ,406.13, transfers, 
28-Jul-18, To Holidays   ,2,  ,  ,  ,407.37, transfers, 
27-Jul-18, To Holidays   ,0.9,  ,  ,  ,409.37, transfers, 
27-Jul-18, To Holidays   ,2,  ,  ,  ,410.27, transfers, 
27-Jul-18, To Holidays   ,0.4,  ,  ,  ,412.27, transfers, 
27-Jul-18, Payment from L Maresca  ,  ,400,  ,  ,412.67, general, MONEY TRANSFER
27-Jul-18, To Holidays   ,0.5,  ,  ,  ,12.67, transfers, 
26-Jul-18, To Holidays   ,1.52,  ,  ,  ,13.17, transfers, 
26-Jul-18, To Robert Mois  ,9.65,  ,  ,  ,14.69, transfers, 
26-Jul-18, Transport for London  ,12.3,  ,  ,  ,24.34, transport, 
26-Jul-18, To Holidays   ,1,  ,  ,  ,36.64, transfers, 
25-Jul-18, Caffè Nero  ,2.05,  ,  ,  ,37.64, restaurants, 
25-Jul-18, Deutsche Bank  ,2.75,  ,  ,  ,39.69, restaurants, 
25-Jul-18, Simple Health Kitchen  ,18.5,  ,  ,  ,42.44, restaurants, 
25-Jul-18, Deutsche Bank  ,3.7,  ,  ,  ,60.94, restaurants, 
25-Jul-18, Deutsche Bank  ,3.75,  ,  ,  ,64.64, restaurants, 
24-Jul-18, Uber Eats  ,13.71,  ,  ,  ,68.39, transport, 
24-Jul-18, Crussh - Fit Food  Ju  ,5.6,  ,  ,  ,82.1, restaurants, 
24-Jul-18, To Holidays   ,1.4,  ,  ,  ,87.7, transfers, 
23-Jul-18, To Holidays   ,0.6,  ,  ,  ,89.1, transfers, 
23-Jul-18, To Holidays   ,0.5,  ,  ,  ,89.7, transfers, 
23-Jul-18, From Robert Mois  ,  ,7.9,  ,  ,90.2, transfers, 
23-Jul-18, To Holidays   ,0.5,  ,  ,  ,82.3, transfers, 
23-Jul-18, To Holidays   ,1,  ,  ,  ,82.8, transfers, 
23-Jul-18, itsu  ,10.58,  ,  ,  ,83.8, restaurants, 
23-Jul-18, Blue Posts  ,5.9,  ,  ,  ,94.38, restaurants, 
23-Jul-18, To Holidays   ,1.2,  ,  ,  ,100.28, transfers, 
23-Jul-18, Transport for London  ,2.4,  ,  ,  ,101.48, transport, 
23-Jul-18, Transport for London  ,2,  ,  ,  ,103.88, transport, 
23-Jul-18, To Holidays   ,1.9,  ,  ,  ,105.88, transfers, 
22-Jul-18, To Holidays   ,2,  ,  ,  ,107.78, transfers, 
22-Jul-18, To Holidays   ,0.8,  ,  ,  ,109.78, transfers, 
22-Jul-18, Chilango  ,33.75,  ,  ,  ,110.58, restaurants, 
22-Jul-18, Deutsche Bank  ,3.1,  ,  ,  ,144.33, restaurants, 
22-Jul-18, Caffè Nero  ,3.7,  ,  ,  ,147.43, restaurants, 
22-Jul-18, Deutsche Bank  ,4.8,  ,  ,  ,151.13, restaurants, 
22-Jul-18, To Holidays   ,1.2,  ,  ,  ,155.93, transfers, 
22-Jul-18, Transport for London  ,2.4,  ,  ,  ,157.13, transport, 
22-Jul-18, Starshine Db  ,17.6,  ,  ,  ,159.53, services, 
21-Jul-18, To Holidays   ,0.2,  ,  ,  ,177.13, transfers, 
21-Jul-18, To Holidays   ,0.84,  ,  ,  ,177.33, transfers, 
21-Jul-18, To Holidays   ,2,  ,  ,  ,178.17, transfers, 
21-Jul-18, Cash at Sainsbury's Bank  ,10,  ,  ,  ,180.17, cash, 
21-Jul-18, k10 Mincing Lane  ,16.45,  ,  ,  ,190.17, restaurants, 
21-Jul-18, To Holidays   ,0.4,  ,  ,  ,206.62, transfers, 
21-Jul-18, Transport for London  ,4.8,  ,  ,  ,207.02, transport, 
21-Jul-18, Simple Health Kitchen  ,6.9,  ,  ,  ,211.82, restaurants, 
21-Jul-18, Deutsche Bank  ,7.7,  ,  ,  ,218.72, restaurants, 
21-Jul-18, Deutsche Bank  ,3.1,  ,  ,  ,226.42, restaurants, 
20-Jul-18, From Robert Mois  ,  ,6.9,  ,  ,229.52, transfers, 
20-Jul-18, To Holidays   ,0.5,  ,  ,  ,222.62, transfers, 
20-Jul-18, To Holidays   ,0.8,  ,  ,  ,223.12, transfers, 
20-Jul-18, To Holidays   ,1.8,  ,  ,  ,223.92, transfers, 
20-Jul-18, eat Drink Wolf Limite  ,8.5,  ,  ,  ,225.72, restaurants, 
20-Jul-18, Deutsche Bank  ,1.65,  ,  ,  ,234.22, restaurants, 
20-Jul-18, Deutsche Bank  ,1.65,  ,  ,  ,235.87, restaurants, 
20-Jul-18, Birleys Sandwiches  ,4.85,  ,  ,  ,237.52, restaurants, 
20-Jul-18, Transport for London  ,4.8,  ,  ,  ,242.37, transport, 
20-Jul-18, Deutsche Bank  ,4.95,  ,  ,  ,247.17, restaurants, 
20-Jul-18, To Holidays   ,0.4,  ,  ,  ,252.12, transfers, 
19-Jul-18, To Holidays   ,1.8,  ,  ,  ,252.52, transfers, 
19-Jul-18, From Robert Mois  ,  ,6.9,  ,  ,254.32, transfers, 
19-Jul-18, To Holidays   ,1.1,  ,  ,  ,247.42, transfers, 
19-Jul-18, To Holidays   ,0.2,  ,  ,  ,248.52, transfers, 
19-Jul-18, To Holidays   ,0.6,  ,  ,  ,248.72, transfers, 
19-Jul-18, To Holidays   ,0.6,  ,  ,  ,249.32, transfers, 
19-Jul-18, Housekeeep  ,63.25,  ,  ,  ,249.92, services, 
19-Jul-18, The Swan Tavern  ,14.6,  ,  ,  ,313.17, restaurants, 
19-Jul-18, The Swan Tavern  ,14.6,  ,  ,  ,327.77, restaurants, 
19-Jul-18, The Swan Tavern  ,7.3,  ,  ,  ,342.37, restaurants, 
19-Jul-18, Deutsche Bank  ,6.05,  ,  ,  ,349.67, restaurants, 
19-Jul-18, Pilpel  ,31.15,  ,  ,  ,355.72, restaurants, 
18-Jul-18, To Gianluigi Coccia  ,10,  ,  ,  ,386.87, transfers, 
18-Jul-18, To Holidays   ,0.7,  ,  ,  ,396.87, transfers, 
18-Jul-18, To Holidays   ,1,  ,  ,  ,397.57, transfers, 
18-Jul-18, To Holidays   ,0.7,  ,  ,  ,398.57, transfers, 
18-Jul-18, Deutsche Bank  ,3,  ,  ,  ,399.27, restaurants, 
18-Jul-18, Deutsche Bank  ,0.9,  ,  ,  ,402.27, restaurants, 
18-Jul-18, Piada Bar  ,9.2,  ,  ,  ,403.17, restaurants, 
18-Jul-18, Deutsche Bank  ,8.3,  ,  ,  ,412.37, restaurants, 
18-Jul-18, To Holidays   ,0.1,  ,  ,  ,420.67, transfers, 
18-Jul-18, To Holidays   ,0.3,  ,  ,  ,420.77, transfers, 
18-Jul-18, To Holidays   ,0.4,  ,  ,  ,421.07, transfers, 
17-Jul-18, To Holidays   ,1.5,  ,  ,  ,421.47, transfers, 
17-Jul-18, To Holidays   ,0.8,  ,  ,  ,422.97, transfers, 
17-Jul-18, To Holidays   ,1.4,  ,  ,  ,423.77, transfers, 
17-Jul-18, To Holidays   ,0.8,  ,  ,  ,425.17, transfers, 
17-Jul-18, From Robert Mois  ,  ,6.6,  ,  ,425.97, transfers, 
17-Jul-18, From Susanna Hassinen  ,  ,6,  ,  ,419.37, transfers, 
17-Jul-18, From Thomas Konig  ,  ,6.7,  ,  ,413.37, transfers, 
17-Jul-18, To Holidays   ,1.7,  ,  ,  ,406.67, transfers, 
17-Jul-18, Cash at Royal Bank of Scotland  ,10,  ,  ,  ,408.37, cash, 
17-Jul-18, La Petite Poissonnerie  ,11.2,  ,  ,  ,418.37, groceries, 
17-Jul-18, The Good Egg  ,21.04,  ,  ,  ,429.57, restaurants, 
17-Jul-18, Tesco Superstore  ,7.75,  ,  ,  ,450.61, groceries, 
17-Jul-18, Tesco Superstore  ,0.1,  ,  ,  ,458.36, groceries, 
17-Jul-18, Primrose Bakery  ,2,  ,  ,  ,458.46, groceries, 
17-Jul-18, Hilco Supermarket Limited  ,4.57,  ,  ,  ,460.46, groceries, 
17-Jul-18, To Holidays   ,1.9,  ,  ,  ,465.03, transfers, 
16-Jul-18, To Holidays   ,2,  ,  ,  ,466.93, transfers, 
16-Jul-18, To Holidays   ,0.2,  ,  ,  ,468.93, transfers, 
16-Jul-18, To Holidays   ,1.4,  ,  ,  ,469.13, transfers, 
16-Jul-18, Mandarin Oriental Hyde Park. London  ,7.45,  ,  ,  ,470.53, restaurants, 
16-Jul-18, sketch  ,31.5,  ,  ,  ,477.98, restaurants, 
16-Jul-18, Uber Eats  ,7.28,  ,  ,  ,509.48, transport, 
16-Jul-18, Waitrose  ,0.69,  ,  ,  ,516.76, groceries, 
16-Jul-18, Tesco Superstore  ,12.93,  ,  ,  ,517.45, groceries, 
16-Jul-18, TortelliniCup London  ,9.2,  ,  ,  ,530.38, restaurants, 
16-Jul-18, Va Swiss Cottage  ,138,  ,  ,  ,539.58, entertainment, 
16-Jul-18, Mandarin Oriental Hyde Park. London  ,7.65,  ,  ,  ,677.58, restaurants, 
16-Jul-18, To Holidays   ,1.6,  ,  ,  ,685.23, transfers, 
15-Jul-18, To Holidays   ,1.92,  ,  ,  ,686.83, transfers, 
15-Jul-18, To Wioleta Bogalecka  ,100,  ,  ,  ,688.75, transfers, 
15-Jul-18, Payment from L Maresca  ,  ,500,  ,  ,788.75, general, MONEY TRANSFER
15-Jul-18, To Wioleta Bogalecka  ,611.25,  ,  ,  ,288.75, transfers, 
15-Jul-18, To Holidays   ,1.8,  ,  ,  ,900, transfers, 
15-Jul-18, To Holidays   ,0.5,  ,  ,  ,901.8, transfers, 
15-Jul-18, To Holidays   ,2,  ,  ,  ,902.3, transfers, 
15-Jul-18, To Holidays   ,1.6,  ,  ,  ,904.3, transfers, 
15-Jul-18, Maddox Club  ,50,  ,  ,  ,905.9, restaurants, 
15-Jul-18, Bierschenke  ,16.1,  ,  ,  ,955.9, restaurants, 
15-Jul-18, Bierschenke  ,6,  ,  ,  ,972, restaurants, 
14-Jul-18, To Holidays   ,0.14,  ,  ,  ,978, transfers, 
14-Jul-18, To Holidays   ,0.86,  ,  ,  ,978.14, transfers, 
14-Jul-18, To Holidays   ,0.7,  ,  ,  ,979, transfers, 
14-Jul-18, To Holidays   ,1.1,  ,  ,  ,979.7, transfers, 
14-Jul-18, To Holidays   ,0.62,  ,  ,  ,980.8, transfers, 
14-Jul-18, To Holidays   ,1.6,  ,  ,  ,981.42, transfers, 
14-Jul-18, To Holidays   ,2,  ,  ,  ,983.02, transfers, 
14-Jul-18, To Holidays   ,1.44,  ,  ,  ,985.02, transfers, 
14-Jul-18, To Holidays   ,0.4,  ,  ,  ,986.46, transfers, 
14-Jul-18, Transport for London  ,6.8,  ,  ,  ,986.86, transport, 
14-Jul-18, To Holidays   ,2,  ,  ,  ,993.66, transfers, 
13-Jul-18, To Holidays   ,1,  ,  ,  ,995.66, transfers, 
13-Jul-18, To Holidays   ,1.8,  ,  ,  ,996.66, transfers, 
13-Jul-18, To Holidays   ,2,  ,  ,  ,998.46, transfers, 
13-Jul-18, Payment from L Maresca  ,  ,1,,,,,
13-Jul-18, Birleys Sandwiches  ,6.25,  ,  ,  ,0.46, restaurants, 
12-Jul-18, From Holidays   ,  ,1.5,  ,  ,6.71, transfers, 
12-Jul-18, Transport for London  ,4.8,  ,  ,  ,5.21, transport, 
12-Jul-18, Deutsche Bank  ,6.5,  ,  ,  ,10.01, restaurants, 
12-Jul-18, pod  ,7.87,  ,  ,  ,16.51, restaurants, 
11-Jul-18, Cash at Lloyds Banking Group Offices  ,20,  ,  ,  ,24.38, cash, 
11-Jul-18, Hilco Supermarket Limited  ,16.96,  ,  ,  ,44.38, groceries, 
11-Jul-18, To Holidays   ,1.5,  ,  ,  ,61.34, transfers, 
10-Jul-18, From Holidays   ,  ,4.92,  ,  ,62.84, transfers, 
10-Jul-18, To Holidays   ,0.26,  ,  ,  ,57.92, transfers, 
10-Jul-18, To Holidays   ,0.6,  ,  ,  ,58.18, transfers, 
10-Jul-18, Espressamente Illy Coffee Shop. London  ,4.8,  ,  ,  ,58.78, restaurants, 
10-Jul-18, To Holidays   ,1,  ,  ,  ,63.58, transfers, 
10-Jul-18, Transport for London  ,1.7,  ,  ,  ,64.58, transport, 
10-Jul-18, Halfords  ,4.8,  ,  ,  ,66.28, transport, 
10-Jul-18, Buongiorno e Buonasera  ,6.11,  ,  ,  ,71.08, restaurants, 
10-Jul-18, Royal Exchange Grind  ,12.45,  ,  ,  ,77.19, restaurants, 
09-Jul-18, To Holidays   ,0.08,  ,  ,  ,89.64, transfers, 
09-Jul-18, To Holidays   ,0.4,  ,  ,  ,89.72, transfers, 
09-Jul-18, Whole Foods Market  ,3.99,  ,  ,  ,90.12, groceries, 
09-Jul-18, Transport for London  ,6.8,  ,  ,  ,94.11, transport, 
09-Jul-18, Uber Eats  ,15.29,  ,  ,  ,100.91, transport, 
09-Jul-18, Drunch  ,14.26,  ,  ,  ,116.2, restaurants, 
09-Jul-18, Santander Cycle Hire  ,2,  ,  ,  ,130.46, transport, 
09-Jul-18, Transport for London  ,6.8,  ,  ,  ,132.46, transport, 
09-Jul-18, Regent News  ,8.5,  ,  ,  ,139.26, shopping, 
09-Jul-18, Tesco Express  ,7.1,  ,  ,  ,147.76, groceries, 
09-Jul-18, Cargo  ,20,  ,  ,  ,154.86, restaurants, 
08-Jul-18, To Holidays   ,1.78,  ,  ,  ,174.86, transfers, 
08-Jul-18, To Holidays   ,0.4,  ,  ,  ,176.64, transfers, 
08-Jul-18, To Holidays   ,0.4,  ,  ,  ,177.04, transfers, 
08-Jul-18, Tesco Express  ,9.45,  ,  ,  ,177.44, groceries, 
08-Jul-18, White Horse Kebab House London  ,15,  ,  ,  ,186.89, restaurants, 
08-Jul-18, From Holidays   ,  ,49.68,  ,  ,201.89, transfers, 
08-Jul-18, To Holidays   ,0.4,  ,  ,  ,152.21, transfers, 
08-Jul-18, To Holidays   ,1.42,  ,  ,  ,152.61, transfers, 
07-Jul-18, From Holidays   ,  ,50,  ,  ,154.03, transfers, 
07-Jul-18, To Holidays   ,1.48,  ,  ,  ,104.03, transfers, 
07-Jul-18, To Holidays   ,2,  ,  ,  ,105.51, transfers, 
07-Jul-18, To Holidays   ,1,  ,  ,  ,107.51, transfers, 
07-Jul-18, To Holidays   ,0.02,  ,  ,  ,108.51, transfers, 
07-Jul-18, To Holidays   ,1.8,  ,  ,  ,108.53, transfers, 
07-Jul-18, To Holidays   ,0.4,  ,  ,  ,110.33, transfers, 
07-Jul-18, Transport for London  ,4.8,  ,  ,  ,110.73, transport, 
07-Jul-18, Chilango  ,29.7,  ,  ,  ,115.53, restaurants, 
07-Jul-18, To Holidays   ,2,  ,  ,  ,145.23, transfers, 
06-Jul-18, To Holidays   ,1.1,  ,  ,  ,147.23, transfers, 
06-Jul-18, To Holidays   ,1.1,  ,  ,  ,148.33, transfers, 
06-Jul-18, Transport for London  ,6.8,  ,  ,  ,149.43, transport, 
05-Jul-18, To Holidays   ,2,  ,  ,  ,156.23, transfers, 
05-Jul-18, To Holidays   ,0.6,  ,  ,  ,158.23, transfers, 
05-Jul-18, Deutsche Bank  ,3.15,  ,  ,  ,158.83, restaurants, 
05-Jul-18, Pret A Manger  ,2.7,  ,  ,  ,161.98, restaurants, 
05-Jul-18, Tesco Superstore  ,6.05,  ,  ,  ,164.68, groceries, 
05-Jul-18, To Holidays   ,0.4,  ,  ,  ,170.73, transfers, 
05-Jul-18, Transport for London  ,4.8,  ,  ,  ,171.13, transport, 
05-Jul-18, To Holidays   ,0.4,  ,  ,  ,175.93, transfers, 
04-Jul-18, Payment from L Maresca  ,  ,119,  ,  ,176.33, general, MONEY TRANSFER
04-Jul-18, MW Eat  ,33.2,  ,  ,  ,57.33, restaurants, 
04-Jul-18, itsu  ,10.79,  ,  ,  ,90.53, restaurants, 
04-Jul-18, Deutsche Bank  ,0.7,  ,  ,  ,101.32, groceries, 
04-Jul-18, Transport for London  ,4.8,  ,  ,  ,102.02, transport, 
03-Jul-18, To Holidays   ,1.9,  ,  ,  ,106.82, transfers, 
03-Jul-18, To Holidays   ,1.7,  ,  ,  ,108.72, transfers, 
03-Jul-18, To Holidays   ,0.6,  ,  ,  ,110.42, transfers, 
02-Jul-18, To Holidays   ,0.42,  ,  ,  ,111.02, transfers, 
02-Jul-18, To Holidays   ,0.6,  ,  ,  ,111.44, transfers, 
02-Jul-18, Uber Eats  ,16.92,  ,  ,  ,112.04, transport, 
02-Jul-18, UNIQLO Europe Limited  ,34.9,  ,  ,  ,128.96, shopping, 
02-Jul-18, Santa Maria  ,34.82,  ,  ,  ,163.86, restaurants, 
02-Jul-18, Buongiorno e Buonasera  ,6.79,  ,  ,  ,198.68, restaurants, 
01-Jul-18, To Holidays   ,1.6,  ,  ,  ,205.47, transfers, 
01-Jul-18, To Lorenz Maresca  ,300,  ,  ,  ,207.07, transfers, 
01-Jul-18, To Holidays   ,0.4,  ,  ,  ,507.07, transfers, 
01-Jul-18, To Holidays   ,0.9,  ,  ,  ,507.47, transfers, 
01-Jul-18, To Christopher Maclean  ,1,,,,,,
01-Jul-18, Cash at Sainsbury's Bank  ,20,  ,  ,  ,1,,
01-Jul-18, Transport for London  ,6.8,  ,  ,  ,1,,
01-Jul-18, Deutsche Bank  ,0.7,  ,  ,  ,1,,
01-Jul-18, Transport for London  ,4.8,  ,  ,  ,1,,
01-Jul-18, Deutsche Bank  ,2.55,  ,  ,  ,1,,
30-Jun-18, To Holidays   ,1.5,  ,  ,  ,1,,
30-Jun-18, To Holidays   ,1.5,  ,  ,  ,1,,
30-Jun-18, To Holidays   ,0.2,  ,  ,  ,1,,
30-Jun-18, To Holidays   ,0.42,  ,  ,  ,1,,
30-Jun-18, Tesco Superstore  ,3.29,  ,  ,  ,1,,
30-Jun-18, Payment from L Maresca  ,  ,400,  ,  ,1,,
30-Jun-18, To Holidays   ,0.4,  ,  ,  ,1,,
30-Jun-18, To Holidays   ,0.16,  ,  ,  ,1,,
29-Jun-18, Exchange  to GBP FX Rate £1 = €1.1286 ,  ,703.48,  EUR 794.00 ,  ,1,,
29-Jun-18, To Holidays   ,0.36,  ,  ,  ,847.21, transfers, 
29-Jun-18, Payment from Iwoca Ltd  ,  ,820.94,  ,  ,847.57, general, IWOCA SALARY
29-Jun-18, To Holidays   ,0.6,  ,  ,  ,26.63, transfers, 
29-Jun-18, The Fine Line  ,10.05,  ,  ,  ,27.23, restaurants, 
29-Jun-18, Transport for London  ,5.8,  ,  ,  ,37.28, transport, 
29-Jun-18, To Holidays   ,0.9,  ,  ,  ,43.08, transfers, 
28-Jun-18, From Holidays   ,  ,10,  ,  ,43.98, transfers, 
28-Jun-18, From Holidays   ,  ,10,  ,  ,33.98, transfers, 
28-Jun-18, To Holidays   ,1.42,  ,  ,  ,23.98, transfers, 
28-Jun-18, Cash at Cash Converters - Kilb2  ,11.95,  ,  ,  ,25.4, cash, 
27-Jun-18, To Holidays   ,1.9,  ,  ,  ,37.35, transfers, 
27-Jun-18, To Holidays   ,0.4,  ,  ,  ,39.25, transfers, 
27-Jun-18, Transport for London  ,6.8,  ,  ,  ,39.65, transport, 
27-Jun-18, Birleys Sandwiches  ,2.25,  ,  ,  ,46.45, restaurants, 
27-Jun-18, Caffè Nero  ,1.75,  ,  ,  ,48.7, restaurants, 
27-Jun-18, To Holidays   ,0.4,  ,  ,  ,50.45, transfers, 
26-Jun-18, To Lorenz Maresca  ,25,  ,  ,  ,50.85, transfers, 
26-Jun-18, TortelliniCup London  ,12.5,  ,  ,  ,75.85, restaurants, 
26-Jun-18, SOHO Coffee Co  ,5.94,  ,  ,  ,88.35, restaurants, 
25-Jun-18, To Lorenz Maresca  ,15,  ,  ,  ,94.29, transfers, 
25-Jun-18, To Holidays   ,0.5,  ,  ,  ,109.29, transfers, 
25-Jun-18, To Holidays   ,1.2,  ,  ,  ,109.79, transfers, 
25-Jun-18, Transport for London  ,2.4,  ,  ,  ,110.99, transport, 
25-Jun-18, Buongiorno e Buonasera  ,7.38,  ,  ,  ,113.39, restaurants, 
25-Jun-18, Courthouse Hotel  ,15.75,  ,  ,  ,120.77, travel, 
25-Jun-18, Boots  ,0.8,  ,  ,  ,136.52, health, 
25-Jun-18, sketch  ,19.69,  ,  ,  ,137.32, restaurants, 
25-Jun-18, To Holidays   ,1.5,  ,  ,  ,157.01, transfers, 
24-Jun-18, To Holidays   ,1,  ,  ,  ,158.51, transfers, 
24-Jun-18, To Holidays   ,0.12,  ,  ,  ,159.51, transfers, 
24-Jun-18, To Lorenz Maresca  ,40,  ,  ,  ,159.63, transfers, 
24-Jun-18, Uber Eats  ,20.8,  ,  ,  ,199.63, transport, 
24-Jun-18, London Stansted Airport  ,17,  ,  ,  ,220.43, transport, 
24-Jun-18, Transport for London  ,4.4,  ,  ,  ,237.43, transport, 
24-Jun-18, Sainsbury's  ,0.5,  ,  ,  ,241.83, groceries, 
23-Jun-18, To Paolo Schiavone  ,12.5,  ,  ,  ,242.33, transfers, 
23-Jun-18, Exchange  to GBP FX Rate £1 = €1.1423 ,  ,153.1,  EUR 174.90 ,  ,254.83, general, 
23-Jun-18, To Holidays   ,0.5,  ,  ,  ,101.73, transfers, 
23-Jun-18, To Holidays   ,0.4,  ,  ,  ,102.23, transfers, 
23-Jun-18, To Holidays   ,1.24,  ,  ,  ,102.63, transfers, 
23-Jun-18, To Holidays   ,1.2,  ,  ,  ,103.87, transfers, 
23-Jun-18, To Holidays   ,0.4,  ,  ,  ,105.07, transfers, 
23-Jun-18, To Holidays   ,0.62,  ,  ,  ,105.47, transfers, 
22-Jun-18, To Holidays   ,1,  ,  ,  ,106.09, transfers, 
22-Jun-18, To Holidays   ,2,  ,  ,  ,107.09, transfers, 
11-Jun-18, To Lorenz Maresca  ,50,  ,  ,  ,109.09, transfers, 
11-Jun-18, Exchange  to GBP FX Rate £1 = €1.1344 ,  ,158.66,  EUR 180.00 ,  ,159.09, general, 
07-Jun-18, Cash at Lloyds Banking Group Offices  ,20,  ,  ,  ,0.43, cash, 
06-Jun-18, Buongiorno e Buonasera  ,13.04,  ,  ,  ,20.43, restaurants, 
06-Jun-18, Lido Bar and Cafe  ,5,  ,  ,  ,33.47, restaurants, 
06-Jun-18, Creative Mobile Technologies (UK) Ltd  ,11,  ,  ,  ,38.47, transport, 
06-Jun-18, PAUL  ,5.25,  ,  ,  ,49.47, restaurants, 
05-Jun-18, To Holidays   ,0.6,  ,  ,  ,54.72, transfers, 
05-Jun-18, Transport for London  ,2.4,  ,  ,  ,55.32, transport, 
05-Jun-18, Starbucks  ,1.8,  ,  ,  ,57.72, restaurants, 
03-Jun-18, To Holidays   ,0.96,  ,  ,  ,59.52, transfers, 
03-Jun-18, To Holidays   ,0.75,  ,  ,  ,60.48, transfers, 
03-Jun-18, Anglesea Arms  ,7.9,  ,  ,  ,61.23, restaurants, 
03-Jun-18, Anglesea Arms  ,7.9,  ,  ,  ,69.13, restaurants, 
03-Jun-18, To Holidays   ,0.75,  ,  ,  ,77.03, transfers, 
03-Jun-18, Tesco Superstore  ,4.25,  ,  ,  ,77.78, groceries, 
03-Jun-18, To Holidays   ,0.25,  ,  ,  ,82.03, transfers, 
03-Jun-18, Starbucks Coffee  ,3.75,  ,  ,  ,82.28, restaurants, 
03-Jun-18, Sainsbury's  ,45.51,  ,  ,  ,86.03, groceries, 
03-Jun-18, TortelliniCup London  ,60,  ,  ,  ,131.54, restaurants, 
03-Jun-18, To Holidays   ,1,  ,  ,  ,191.54, transfers, 
02-Jun-18, Exchange  to GBP FX Rate £1 = €1.1491 ,  ,43.51,  EUR 50.00 ,  ,192.54, general, 
02-Jun-18, To Holidays   ,0.2,  ,  ,  ,149.03, transfers, 
02-Jun-18, To Holidays   ,1,  ,  ,  ,149.23, transfers, 
01-Jun-18, To Holidays   ,0.49,  ,  ,  ,150.23, transfers, 
01-Jun-18, To Holidays   ,1,  ,  ,  ,150.72, transfers, 
01-Jun-18, Exchange  to GBP FX Rate £1 = €1.1458 ,  ,130.9,  EUR 150.00 ,  ,151.72, general, 
01-Jun-18, Sainsbury's  ,40,  ,  ,  ,20.82, groceries, 
31-May-18, Cash at Royal Bank of Scotland  ,10,  ,  ,  ,60.82, cash, 
31-May-18, Transport for London  ,5.5,  ,  ,  ,70.82, transport, 
31-May-18, To Christopher Maclean  ,1,,,,,,
31-May-18, To Holidays   ,0.1,  ,  ,  ,1,,
31-May-18, Payment from Iwoca Ltd  ,  ,1,,,,,
31-May-18, To Holidays   ,0.1,  ,  ,  ,353.24, transfers, 
31-May-18, SOHO Coffee Co  ,1.7,  ,  ,  ,353.34, restaurants, 
31-May-18, Hilco Supermarket Limited  ,15.44,  ,  ,  ,355.04, groceries, 
31-May-18, TortelliniCup London  ,4.5,  ,  ,  ,370.48, restaurants, 
30-May-18, To Holidays   ,1,  ,  ,  ,374.98, transfers, 
29-May-18, To Luca Mircoli  ,10,  ,  ,  ,375.98, transfers, 
29-May-18, To Lorenz Maresca  ,20,  ,  ,  ,385.98, transfers, 
29-May-18, To Holidays   ,0.5,  ,  ,  ,405.98, transfers, 
28-May-18, TortelliniCup London  ,6.1,  ,  ,  ,406.48, restaurants, 
28-May-18, Nyx healthyvendingco  ,1.4,  ,  ,  ,412.58, groceries, 
28-May-18, To Holidays   ,0.56,  ,  ,  ,413.98, transfers, 
28-May-18, To Holidays   ,0.3,  ,  ,  ,414.54, transfers, 
28-May-18, To Holidays   ,0.5,  ,  ,  ,414.84, transfers, 
28-May-18, Payment from L Maresca  ,  ,400,  ,  ,415.34, general, MONEY TRANSFER
27-May-18, Cash at Lloyd Northover  ,20,  ,  ,  ,15.34, cash, 
27-May-18, Cash at Hv Thomas Chemist  ,10,  ,  ,  ,35.34, cash, 
27-May-18, All Bar One Oxford Street  ,6.4,  ,  ,  ,45.34, restaurants, 
27-May-18, All Bar One Oxford Street  ,5.5,  ,  ,  ,51.74, restaurants, 
26-May-18, To Holidays   ,0.6,  ,  ,  ,57.24, transfers, 
26-May-18, To Holidays   ,0.9,  ,  ,  ,57.84, transfers, 
26-May-18, TortelliniCup London  ,8.6,  ,  ,  ,58.74, restaurants, 
26-May-18, Park Plaza Sherlock Holmes London  ,5.4,  ,  ,  ,67.34, restaurants, 
25-May-18, Cash at Royal Bank of Scotland  ,10,  ,  ,  ,72.74, cash, 
25-May-18, Wasabi Sushi & Bento  ,8,  ,  ,  ,82.74, restaurants, 
25-May-18, To Holidays   ,0.5,  ,  ,  ,90.74, transfers, 
25-May-18, To Holidays   ,0.6,  ,  ,  ,91.24, transfers, 
24-May-18, Courthouse Hotel  ,31.5,  ,  ,  ,91.84, travel, 
24-May-18, Espressamente Illy Coffee Shop. London  ,3.8,  ,  ,  ,123.34, restaurants, 
24-May-18, To Holidays   ,0.4,  ,  ,  ,127.14, transfers, 
24-May-18, To Holidays   ,0.6,  ,  ,  ,127.54, transfers, 
23-May-18, To Holidays   ,1,  ,  ,  ,128.14, transfers, 
23-May-18, Shepherds Market Wine  ,35.44,  ,  ,  ,129.14, restaurants, 
23-May-18, Princi  ,29,  ,  ,  ,164.58, restaurants, 
23-May-18, One Stop  ,12.45,  ,  ,  ,193.58, groceries, 
23-May-18, Boots  ,2.85,  ,  ,  ,206.03, health, 
23-May-18, Tesco Superstore  ,10.45,  ,  ,  ,208.88, transport, 
22-May-18, From Luca Mircoli  ,  ,15.75,  ,  ,219.33, transfers, Courthouse Hotel
22-May-18, To Holidays   ,0.5,  ,  ,  ,203.58, transfers, 
22-May-18, To Holidays   ,0.2,  ,  ,  ,204.08, transfers, 
22-May-18, McDonald's  ,0.99,  ,  ,  ,204.28, restaurants, 
22-May-18, Iz *the Jewish Del  ,8,  ,  ,  ,205.27, restaurants, 
21-May-18, To Lorenz Maresca  ,20,  ,  ,  ,213.27, transfers, 
21-May-18, To Lorenz Maresca  ,35,  ,  ,  ,233.27, transfers, 
20-May-18, To Lorenz Maresca  ,100,  ,  ,  ,268.27, transfers, 
20-May-18, To Holidays   ,0.55,  ,  ,  ,368.27, transfers, 
20-May-18, To Holidays   ,0.56,  ,  ,  ,368.82, transfers, 
20-May-18, To Holidays   ,0.15,  ,  ,  ,369.38, transfers, 
20-May-18, To Luca Mircoli  ,11,  ,  ,  ,369.53, transfers, 
20-May-18, Negozio Classica  ,51.23,  ,  ,  ,380.53, restaurants, 
19-May-18, To Holidays   ,0.01,  ,  ,  ,431.76, transfers, 
19-May-18, To Holidays   ,1,  ,  ,  ,431.77, transfers, 
19-May-18, To Holidays   ,0.55,  ,  ,  ,432.77, transfers, 
19-May-18, To Holidays   ,1,  ,  ,  ,433.32, transfers, 
19-May-18, Sainsbury's  ,2,  ,  ,  ,434.32, groceries, 
18-May-18, To Holidays   ,0.77,  ,  ,  ,436.32, transfers, 
18-May-18, Exchange  to GBP FX Rate £1 = €1.1427 ,  ,434.92,  EUR 497.00 ,  ,437.09, general, 
18-May-18, Cash at Santander Plc (uk)  ,20,  ,  ,  ,2.17, cash, 
18-May-18, Marylebone  ,1.2,  ,  ,  ,22.17, restaurants, 
18-May-18, UoW  ,1.5,  ,  ,  ,23.37, restaurants, 
18-May-18, Park Plaza Sherlock Holmes London  ,7.02,  ,  ,  ,24.87, restaurants, 
18-May-18, Park Plaza Sherlock Holmes London  ,2.5,  ,  ,  ,31.89, restaurants, 
18-May-18, Park Plaza Sherlock Holmes London  ,3.5,  ,  ,  ,34.39, restaurants, 
17-May-18, Marylebone  ,3,  ,  ,  ,37.89, restaurants, 
17-May-18, Marylebone  ,1.2,  ,  ,  ,40.89, restaurants, 
17-May-18, Buongiorno e Buonasera  ,7.64,  ,  ,  ,42.09, restaurants, 
16-May-18, Buongiorno e Buonasera  ,9.08,  ,  ,  ,49.73, restaurants, 
16-May-18, Park Plaza Sherlock Holmes London  ,6,  ,  ,  ,58.81, restaurants, 
16-May-18, To Holidays   ,0.5,  ,  ,  ,64.81, transfers, 
16-May-18, To Holidays   ,0.8,  ,  ,  ,65.31, transfers, 
16-May-18, To Holidays   ,0.98,  ,  ,  ,66.11, transfers, 
16-May-18, To Holidays   ,0.5,  ,  ,  ,67.09, transfers, 
16-May-18, To Holidays   ,0.5,  ,  ,  ,67.59, transfers, 
16-May-18, Fucina  ,4,  ,  ,  ,68.09, restaurants, 
16-May-18, To Holidays   ,0.2,  ,  ,  ,72.09, transfers, 
16-May-18, Transport for London  ,4.8,  ,  ,  ,72.29, transport, 
16-May-18, Pret A Manger  ,1.99,  ,  ,  ,77.09, restaurants, 
16-May-18, Paperchase  ,5,  ,  ,  ,79.08, shopping, 
16-May-18, Marylebone High Street Express  ,0.89,  ,  ,  ,84.08, groceries, 
15-May-18, To Holidays   ,1,  ,  ,  ,84.97, transfers, 
15-May-18, To Holidays   ,0.8,  ,  ,  ,85.97, transfers, 
15-May-18, To Holidays   ,0.36,  ,  ,  ,86.77, transfers, 
15-May-18, Cash at Royal Bank of Scotland  ,20,  ,  ,  ,87.13, cash, 
15-May-18, Whole Foods Market  ,20,  ,  ,  ,107.13, groceries, 
15-May-18, From Luca Mircoli  ,  ,12,  ,  ,127.13, transfers, 
14-May-18, To Holidays   ,0.2,  ,  ,  ,115.13, transfers, 
14-May-18, To Holidays   ,0.92,  ,  ,  ,115.33, transfers, 
14-May-18, To Holidays   ,1,  ,  ,  ,116.25, transfers, 
14-May-18, To Lorenz Maresca  ,200,  ,  ,  ,117.25, transfers, 
14-May-18, Exchange  to GBP FX Rate £1 = €1.1337 ,  ,264.6,  EUR 300.00 ,  ,317.25, general, 
14-May-18, To Holidays   ,0.2,  ,  ,  ,52.65, transfers, 
14-May-18, To Holidays   ,0.2,  ,  ,  ,52.85, transfers, 
13-May-18, To Holidays   ,0.11,  ,  ,  ,53.05, transfers, 
13-May-18, To Holidays   ,0.65,  ,  ,  ,53.16, transfers, 
13-May-18, To Holidays   ,1,  ,  ,  ,53.81, transfers, 
13-May-18, To Holidays   ,0.01,  ,  ,  ,54.81, transfers, 
13-May-18, To Holidays   ,1,  ,  ,  ,54.82, transfers, 
13-May-18, To Lorenz Maresca  ,25,  ,  ,  ,55.82, transfers, 
13-May-18, Park Plaza Sherlock Holmes London  ,4.95,  ,  ,  ,80.82, restaurants, 
13-May-18, Park Plaza Sherlock Holmes London  ,11.07,  ,  ,  ,85.77, restaurants, 
13-May-18, Park Plaza Sherlock Holmes London  ,3.5,  ,  ,  ,96.84, restaurants, 
13-May-18, Park Plaza Sherlock Holmes London  ,3.9,  ,  ,  ,100.34, restaurants, 
13-May-18, Oxo Tower Restaura  ,18,  ,  ,  ,104.24, restaurants, 
12-May-18, Cash at Sainsbury's Bank  ,20,  ,  ,  ,122.24, cash, 
12-May-18, Park Plaza Sherlock Holmes London  ,15.57,  ,  ,  ,142.24, restaurants, 
12-May-18, Park Plaza Sherlock Holmes London  ,9.15,  ,  ,  ,157.81, restaurants, 
12-May-18, TortelliniCup London  ,8,  ,  ,  ,166.96, restaurants, 
12-May-18, Marylebone  ,1.5,  ,  ,  ,174.96, restaurants, 
12-May-18, UoW  ,3.3,  ,  ,  ,176.46, restaurants, 
12-May-18, Marylebone  ,1.5,  ,  ,  ,179.76, restaurants, 
12-May-18, Marylebone  ,1.2,  ,  ,  ,181.26, restaurants, 
11-May-18, To Holidays   ,1,  ,  ,  ,182.46, transfers, 
11-May-18, To Holidays   ,1,  ,  ,  ,183.46, transfers, 
11-May-18, To Holidays   ,0.05,  ,  ,  ,184.46, transfers, 
11-May-18, To Holidays   ,0.93,  ,  ,  ,184.51, transfers, 
11-May-18, Marylebone  ,4.55,  ,  ,  ,185.44, restaurants, 
11-May-18, Sainsbury's  ,3.09,  ,  ,  ,189.99, groceries, 
11-May-18, TortelliniCup London  ,10.2,  ,  ,  ,193.08, restaurants, 
11-May-18, Park Plaza Sherlock Holmes London  ,3,  ,  ,  ,203.28, restaurants, 
11-May-18, Park Plaza Sherlock Holmes London  ,5.4,  ,  ,  ,206.28, restaurants, 
11-May-18, Marylebone  ,4.95,  ,  ,  ,211.68, restaurants, 
11-May-18, Marylebone  ,1.85,  ,  ,  ,216.63, restaurants, 
11-May-18, Sainsbury's  ,3,  ,  ,  ,218.48, groceries, 
11-May-18, To Holidays   ,0.5,  ,  ,  ,221.48, transfers, 
11-May-18, To Holidays   ,0.1,  ,  ,  ,221.98, transfers, 
11-May-18, From Holidays   ,  ,50,  ,  ,222.08, transfers, 
10-May-18, To Holidays   ,1,  ,  ,  ,172.08, transfers, 
10-May-18, To Holidays   ,0.8,  ,  ,  ,173.08, transfers, 
10-May-18, To Holidays   ,0.43,  ,  ,  ,173.88, transfers, 
10-May-18, Park Plaza Sherlock Holmes London  ,1,  ,  ,  ,174.31, restaurants, 
10-May-18, Park Plaza Sherlock Holmes London  ,1.9,  ,  ,  ,175.31, restaurants, 
10-May-18, To Holidays   ,0.5,  ,  ,  ,177.21, transfers, 
10-May-18, To Holidays   ,0.7,  ,  ,  ,177.71, transfers, 
10-May-18, To Holidays   ,0.85,  ,  ,  ,178.41, transfers, 
09-May-18, To Holidays   ,0.8,  ,  ,  ,179.26, transfers, 
09-May-18, To Holidays   ,50,  ,  ,  ,180.06, transfers, 
09-May-18, To Holidays   ,0.5,  ,  ,  ,230.06, transfers, 
09-May-18, Mandarin Oriental Hyde Park. London  ,4.85,  ,  ,  ,230.56, restaurants, 
09-May-18, Tesco Superstore  ,1.9,  ,  ,  ,235.41, groceries, 
09-May-18, DF/Mexico  ,14.2,  ,  ,  ,237.31, restaurants, 
09-May-18, Mandarin Oriental Hyde Park. London  ,2,  ,  ,  ,251.51, restaurants, 
09-May-18, To Holidays   ,1,  ,  ,  ,253.51, transfers, 
09-May-18, To Holidays   ,1,  ,  ,  ,254.51, transfers, 
09-May-18, To Holidays   ,0.6,  ,  ,  ,255.51, transfers, 
09-May-18, To Holidays   ,0.45,  ,  ,  ,256.11, transfers, 
09-May-18, Exchange  to GBP FX Rate £1 = €1.1419 ,  ,175.14,  EUR 200.00 ,  ,256.56, general, 
09-May-18, Costa Coffee  ,3.75,  ,  ,  ,81.42, restaurants, 
09-May-18, Ryman  ,4.99,  ,  ,  ,85.17, utilities, 
08-May-18, To Holidays   ,0.91,  ,  ,  ,90.16, transfers, 
08-May-18, To Holidays   ,0.15,  ,  ,  ,91.07, transfers, 
08-May-18, To Holidays   ,0.05,  ,  ,  ,91.22, transfers, 
08-May-18, To Holidays   ,1,  ,  ,  ,91.27, transfers, 
08-May-18, To Holidays   ,0.1,  ,  ,  ,92.27, transfers, 
07-May-18, Marylebone  ,4.55,  ,  ,  ,92.37, restaurants, 
07-May-18, Fucina  ,4,  ,  ,  ,96.92, restaurants, 
07-May-18, Hilco Supermarket Limited  ,17.17,  ,  ,  ,100.92, groceries, 
07-May-18, Starbucks Coffee  ,4.85,  ,  ,  ,118.09, restaurants, 
07-May-18, Feng Sushi West  ,69.35,  ,  ,  ,122.94, restaurants, 
07-May-18, Chipotle Mexican Grill  ,10.2,  ,  ,  ,192.29, restaurants, 
07-May-18, To Holidays   ,0.6,  ,  ,  ,202.49, transfers, 
07-May-18, To Holidays   ,0.8,  ,  ,  ,203.09, transfers, 
07-May-18, To Holidays   ,1,  ,  ,  ,203.89, transfers, 
07-May-18, To Holidays   ,0.15,  ,  ,  ,204.89, transfers, 
07-May-18, To Holidays   ,0.1,  ,  ,  ,205.04, transfers, 
06-May-18, To Luca Mircoli  ,16,  ,  ,  ,205.14, transfers, 
06-May-18, To Holidays   ,0.01,  ,  ,  ,221.14, transfers, 
06-May-18, To Holidays   ,0.25,  ,  ,  ,221.15, transfers, 
06-May-18, Planet Organic  ,4.5,  ,  ,  ,221.4, groceries, 
06-May-18, TortelliniCup London  ,4.5,  ,  ,  ,225.9, restaurants, 
05-May-18, To Holidays   ,0.83,  ,  ,  ,230.4, transfers, 
05-May-18, To Holidays   ,0.15,  ,  ,  ,231.23, transfers, 
05-May-18, To Holidays   ,1,  ,  ,  ,231.38, transfers, 
05-May-18, To Holidays   ,0.8,  ,  ,  ,232.38, transfers, 
05-May-18, Ryanair  ,65.84,  ,  ,  ,233.18, travel, 
05-May-18, Transport for London  ,5.3,  ,  ,  ,299.02, transport, 
05-May-18, To Holidays   ,0.45,  ,  ,  ,304.32, transfers, 
04-May-18, To Holidays   ,0.65,  ,  ,  ,304.77, transfers, 
04-May-18, To Holidays   ,0.5,  ,  ,  ,305.42, transfers, 
04-May-18, To Holidays   ,0.5,  ,  ,  ,305.92, transfers, 
04-May-18, Cash at Sainsbury's Bank  ,20,  ,  ,  ,306.42, cash, 
04-May-18, Cr Ltd Tott?m Crt W1t  ,20,  ,  ,  ,326.42, entertainment, 
04-May-18, Hilco Supermarket Limited  ,27.32,  ,  ,  ,346.42, groceries, 
03-May-18, The Japanese Canteen  ,31.8,  ,  ,  ,373.74, restaurants, 
03-May-18, Chapter Spitalfields  ,1.95,  ,  ,  ,405.54, restaurants, 
03-May-18, Chapter Spitalfields  ,1.65,  ,  ,  ,407.49, restaurants, 
03-May-18, Boots  ,2.99,  ,  ,  ,409.14, health, 
03-May-18, To Lorenz Maresca  ,15,  ,  ,  ,412.13, transfers, 
02-May-18, TortelliniCup London  ,13.4,  ,  ,  ,427.13, restaurants, 
30-Apr-18, To Lorenz Maresca  ,100,  ,  ,  ,440.53, transfers, 
30-Apr-18, To Christopher Maclean  ,1,,,,,,
30-Apr-18, Exchange  to GBP FX Rate £1 = €1.1371 ,  ,714.08,  EUR 812.00 ,  ,1,,
30-Apr-18, Payment from Complete Accountin  ,  ,1,,,,,
30-Apr-18, Transport for London  ,2.9,  ,  ,  ,151.41, transport, 
30-Apr-18, Sainsbury's  ,4.7,  ,  ,  ,154.31, groceries, 
30-Apr-18, Harrow Halls of Residence. University of Westminster  ,3.05,  ,  ,  ,159.01, restaurants, 
30-Apr-18, Transport for London  ,2.4,  ,  ,  ,162.06, transport, 
30-Apr-18, Planet Organic  ,4.5,  ,  ,  ,164.46, groceries, 
30-Apr-18, Waitrose  ,8.5,  ,  ,  ,168.96, groceries, 
30-Apr-18, TortelliniCup London  ,3.8,  ,  ,  ,177.46, restaurants, 
30-Apr-18, Transport for London  ,5.8,  ,  ,  ,181.26, transport, 
30-Apr-18, TortelliniCup London  ,13.8,  ,  ,  ,187.06, restaurants, 
29-Apr-18, Transport for London  ,6.8,  ,  ,  ,200.86, transport, 
29-Apr-18, TortelliniCup London  ,12.8,  ,  ,  ,207.66, restaurants, 
28-Apr-18, Sainsbury's  ,50.03,  ,  ,  ,220.46, groceries, 
28-Apr-18, Starbucks Coffee  ,3.75,  ,  ,  ,270.49, restaurants, 
28-Apr-18, Ole & Steen  ,2.6,  ,  ,  ,274.24, groceries, 
28-Apr-18, Planet Organic  ,2.4,  ,  ,  ,276.84, groceries, 
28-Apr-18, Hertz Proa Rent A Car FX Rate £1 = €1.1476 ,57.58,  ,  EUR 66.07 ,  ,279.24, transport, 
27-Apr-18, London Stansted Airport  ,30,  ,  ,  ,336.82, transport, 
27-Apr-18, The Japanese Canteen  ,7.95,  ,  ,  ,366.82, restaurants, 
27-Apr-18, Transport for London  ,2.4,  ,  ,  ,374.77, transport, 
25-Apr-18, To Lorenz Maresca  ,40,  ,  ,  ,377.17, transfers, 
23-Apr-18, To Bruno Arturo Fragnito  ,15,  ,  ,  ,417.17, transfers, 
23-Apr-18, To Lorenz Maresca  ,30,  ,  ,  ,432.17, transfers, 
22-Apr-18, To Kseniya Kamen  ,19,  ,  ,  ,462.17, transfers, 
21-Apr-18, World Duty Free Group España S A FX Rate £1 = €1.1472 ,57.54,  ,  EUR 66.00 ,  ,481.17, shopping, 
21-Apr-18, London Stansted Airport  ,10.09,  ,  ,  ,538.71, restaurants, 
21-Apr-18, WH Smith  ,14.68,  ,  ,  ,548.8, shopping, 
19-Apr-18, To Lorenz Maresca  ,30,  ,  ,  ,563.48, transfers, 
19-Apr-18, Exchange GBP to  FX Rate £1 = €1.1406 ,150,  ,  GBP 150.00 ,  ,593.48, general, 
19-Apr-18, Payment from L Maresca  ,  ,600,  ,  ,743.48, general, MONEY TRANSFER
18-Apr-18, Cash at Sainsbury's Bank  ,20,  ,  ,  ,143.48, cash, 
18-Apr-18, Hilco Supermarket Limited  ,20.65,  ,  ,  ,163.48, groceries, 
18-Apr-18, Transport for London  ,2.4,  ,  ,  ,184.13, transport, 
17-Apr-18, PureGym York  ,12.99,  ,  ,  ,186.53, entertainment, 
17-Apr-18, FishWorks  ,7.9,  ,  ,  ,199.52, restaurants, 
17-Apr-18, The Gallery London  ,11,  ,  ,  ,207.42, restaurants, 
17-Apr-18, Shake Shack Canary Wharf  ,13.5,  ,  ,  ,218.42, restaurants, 
17-Apr-18, Chiltern Firehouse  ,25.3,  ,  ,  ,231.92, restaurants, 
17-Apr-18, The Gallery London  ,11,  ,  ,  ,257.22, restaurants, 
17-Apr-18, Tesco Superstore  ,7.5,  ,  ,  ,268.22, groceries, 
17-Apr-18, Buongiorno e Buonasera  ,7.65,  ,  ,  ,275.72, restaurants, 
15-Apr-18, Sainsbury's  ,2.7,  ,  ,  ,283.37, groceries, 
15-Apr-18, TortelliniCup London  ,8,  ,  ,  ,286.07, restaurants, 
15-Apr-18, Nando's  ,21.95,  ,  ,  ,294.07, restaurants, 
15-Apr-18, Marylebone  ,1.25,  ,  ,  ,316.02, restaurants, 
15-Apr-18, Marylebone  ,1.2,  ,  ,  ,317.27, restaurants, 
14-Apr-18, To Luca Mircoli  ,6,  ,  ,  ,318.47, transfers, 
14-Apr-18, Marylebone  ,3.3,  ,  ,  ,324.47, restaurants, 
13-Apr-18, From Maria Fiore Davoli  ,  ,11,  ,  ,327.77, transfers, 
12-Apr-18, To Alberto S  ,20,  ,  ,  ,316.77, transfers, fiums
12-Apr-18, Exchange  to GBP FX Rate £1 = €1.1540 ,  ,331.01,  EUR 382.00 ,  ,336.77, general, 
11-Apr-18, Cash at Sainsbury's Bank  ,20,  ,  ,  ,5.76, cash, 
11-Apr-18, Sainsbury's  ,5,  ,  ,  ,25.76, groceries, 
10-Apr-18, To Wioleta Bogalecka  ,15,  ,  ,  ,30.76, transfers, 
10-Apr-18, Payment from L Maresca  ,  ,13,  ,  ,45.76, general, MONEY TRANSFER
10-Apr-18, Hilco Supermarket Limited  ,20.07,  ,  ,  ,32.76, groceries, 
10-Apr-18, TortelliniCup London  ,19.8,  ,  ,  ,52.83, restaurants, 
10-Apr-18, Pret A Manger  ,1.5,  ,  ,  ,72.63, restaurants, 
10-Apr-18, TortelliniCup London  ,3,  ,  ,  ,74.13, restaurants, 
10-Apr-18, Shoryu Go  ,31.9,  ,  ,  ,77.13, restaurants, 
10-Apr-18, To Wioleta Bogalecka  ,480,  ,  ,  ,109.03, transfers, 
10-Apr-18, Marylebone  ,5.8,  ,  ,  ,589.03, restaurants, 
10-Apr-18, Chipotle Mexican Grill  ,8.8,  ,  ,  ,594.83, restaurants, 
09-Apr-18, Payment from Kamenskikh K  ,  ,30,  ,  ,603.63, general, GRAND CANARIA
08-Apr-18, Exchange  to GBP FX Rate £1 = €1.1538 ,  ,135.19,  EUR 156.00 ,  ,573.63, general, 
08-Apr-18, Wasabi Sushi & Bento  ,12.8,  ,  ,  ,438.44, restaurants, 
07-Apr-18, Airbnb Hm4cejqz3k FX Rate £1 = €1.1455 ,200.16,  ,  EUR 229.28 ,  ,451.24, travel, 
07-Apr-18, Mandarin Oriental Hyde Park. London  ,4,  ,  ,  ,651.4, restaurants, 
07-Apr-18, Park Plaza Sherlock Holmes London  ,1.5,  ,  ,  ,655.4, restaurants, 
07-Apr-18, Park Plaza Sherlock Holmes London  ,13.3,  ,  ,  ,656.9, restaurants, 
07-Apr-18, Marylebone Books  ,4.75,  ,  ,  ,670.2, shopping, 
07-Apr-18, Va Swiss Cottage  ,67.59,  ,  ,  ,674.95, entertainment, 
07-Apr-18, Baskin Robbins  ,10.8,  ,  ,  ,742.54, groceries, 
07-Apr-18, Boots  ,8.98,  ,  ,  ,753.34, health, 
07-Apr-18, Waitrose  ,18.91,  ,  ,  ,762.32, groceries, 
06-Apr-18, Vodafone FX Rate £1 = €1.1450 ,26.03,  ,  EUR 29.80 ,  ,781.23, services, 
05-Apr-18, Iside Ristorante FX Rate £1 = €1.1282 ,132.96,  ,  EUR 150.00 ,  ,807.26, restaurants, 
05-Apr-18, Ondanomala            810 FX Rate £1 = €1.1413 ,24.98,  ,  EUR 28.50 ,  ,940.22, travel, 
04-Apr-18, To Lorenz Maresca  ,20,  ,  ,  ,965.2, transfers, 
04-Apr-18, Exchange  to GBP FX Rate £1 = €1.1449 ,  ,698.74,  EUR 800.00 ,  ,985.2, general, 
02-Apr-18, Exchange GBP to  FX Rate £1 = €1.1418 ,17.5,  ,  GBP 17.50 ,  ,286.46, general, 
02-Apr-18, Genesi S R L  Uniperso FX Rate £1 = €1.1339 ,105.83,  ,  EUR 120.00 ,  ,303.96, restaurants, 
02-Apr-18, Duke?s FX Rate £1 = €1.1391 ,22.83,  ,  EUR 26.00 ,  ,409.79, restaurants, 
30-Mar-18, To Lorenz Maresca  ,20,  ,  ,  ,432.62, transfers, 
29-Mar-18, To Christopher Maclean  ,1,,,,,,
29-Mar-18, Mr Lee  ,9,  ,  ,  ,1,,
29-Mar-18, Iz *brewandwild  ,4.45,  ,  ,  ,1,,
29-Mar-18, Tsgn  ,13.9,  ,  ,  ,1,,
29-Mar-18, London Luton Airport  ,4.75,  ,  ,  ,1,,
29-Mar-18, Payment from Complete Tax Sol  ,  ,1,,,,,
28-Mar-18, Cash at Royal Bank of Scotland  ,10,  ,  ,  ,306.59, cash, 
28-Mar-18, Waitrose  ,23.78,  ,  ,  ,316.59, groceries, 
28-Mar-18, Sainsbury's  ,3.75,  ,  ,  ,340.37, groceries, 
28-Mar-18, Payment from Kamenskikh K  ,  ,20,  ,  ,344.12, general, DINNER
27-Mar-18, Transport for London  ,4.8,  ,  ,  ,324.12, transport, 
27-Mar-18, Vue Bsl Ltd  ,6.5,  ,  ,  ,328.92, entertainment, 
27-Mar-18, Vue Bsl Ltd  ,5,  ,  ,  ,335.42, entertainment, 
27-Mar-18, Sainsbury's  ,0.5,  ,  ,  ,340.42, groceries, 
27-Mar-18, Transport for London  ,2.4,  ,  ,  ,340.92, transport, 
27-Mar-18, Buongiorno e Buonasera  ,38.2,  ,  ,  ,343.32, restaurants, 
27-Mar-18, Marylebone  ,4.3,  ,  ,  ,381.52, restaurants, 
25-Mar-18, To Kseniya Kamen  ,10,  ,  ,  ,385.82, transfers, 
25-Mar-18, Hilco Supermarket Limited  ,16.27,  ,  ,  ,395.82, groceries, 
25-Mar-18, Transport for London  ,2.4,  ,  ,  ,412.09, transport, 
25-Mar-18, Transport for London  ,4.8,  ,  ,  ,414.49, transport, 
25-Mar-18, DF/Mexico  ,21.6,  ,  ,  ,419.29, restaurants, 
25-Mar-18, Tombo Cafe  ,39.2,  ,  ,  ,440.89, restaurants, 
24-Mar-18, Marylebone  ,3.1,  ,  ,  ,480.09, restaurants, 
24-Mar-18, Marylebone  ,2.45,  ,  ,  ,483.19, restaurants, 
23-Mar-18, Tombo Cafe  ,10.65,  ,  ,  ,485.64, restaurants, 
22-Mar-18, Transport for London  ,6.8,  ,  ,  ,496.29, transport, 
22-Mar-18, Hilco Supermarket Limited  ,17.25,  ,  ,  ,503.09, groceries, 
21-Mar-18, Transport for London  ,6.8,  ,  ,  ,520.34, transport, 
20-Mar-18, Payment from L Maresca  ,  ,500,  ,  ,527.14, general, MONEY TRANSFER
20-Mar-18, Cash at Sainsbury's Bank  ,10,  ,  ,  ,27.14, cash, 
20-Mar-18, The Globe Marylebone  ,8.9,  ,  ,  ,37.14, restaurants, 
20-Mar-18, Koya Soho  ,12.84,  ,  ,  ,46.04, restaurants, 
19-Mar-18, Espressamente Illy Coffee Shop. London  ,6.7,  ,  ,  ,58.88, restaurants, 
19-Mar-18, TortelliniCup London  ,11.4,  ,  ,  ,65.58, restaurants, 
19-Mar-18, The London EDITION  ,25.88,  ,  ,  ,76.98, travel, 
19-Mar-18, Transport for London  ,2.4,  ,  ,  ,102.86, transport, 
18-Mar-18, Payment from S Migliorin  ,  ,2.7,  ,  ,105.26, general, FANCULO AHAH
17-Mar-18, Exchange  to GBP FX Rate £1 = €1.1392 ,  ,26.71,  EUR 30.44 ,  ,102.56, general, 
17-Mar-18, Exchange GBP to  FX Rate £1 = €1.1277 ,27,  ,  GBP 27.00 ,  ,75.85, general, 
17-Mar-18, To Luca Mircoli  ,15,  ,  ,  ,102.85, transfers, 
17-Mar-18, Park Plaza Sherlock Holmes London  ,3.95,  ,  ,  ,117.85, restaurants, 
16-Mar-18, Sainsbury's  ,5.75,  ,  ,  ,121.8, groceries, 
15-Mar-18, Whole Foods Market  ,3.49,  ,  ,  ,127.55, groceries, 
15-Mar-18, Whole Foods Market  ,0.99,  ,  ,  ,131.04, groceries, 
15-Mar-18, Whole Foods Market  ,7.49,  ,  ,  ,132.03, groceries, 
15-Mar-18, Transport for London  ,2.9,  ,  ,  ,139.52, transport, 
15-Mar-18, Fierce Grace North  ,10,  ,  ,  ,142.42, services, 
15-Mar-18, Transport for London  ,2.9,  ,  ,  ,152.42, transport, 
15-Mar-18, Waitrose  ,44.64,  ,  ,  ,155.32, groceries, 
14-Mar-18, TortelliniCup London  ,9.2,  ,  ,  ,199.96, restaurants, 
14-Mar-18, Planet Organic  ,4.5,  ,  ,  ,209.16, groceries, 
13-Mar-18, Cash at Sainsbury's Bank  ,20,  ,  ,  ,213.66, cash, 
13-Mar-18, The Japanese Canteen  ,24.85,  ,  ,  ,233.66, restaurants, 
13-Mar-18, Transport for London  ,2.4,  ,  ,  ,258.51, transport, 
12-Mar-18, Waterstones  ,19.97,  ,  ,  ,260.91, shopping, 
12-Mar-18, Zima Russian St Food  ,23.06,  ,  ,  ,280.88, restaurants, 
11-Mar-18, Transport for London  ,4.8,  ,  ,  ,303.94, transport, 
11-Mar-18, Pret A Manger  ,13.97,  ,  ,  ,308.74, restaurants, 
11-Mar-18, Enoteca Da Luca  ,17.78,  ,  ,  ,322.71, restaurants, 
10-Mar-18, Homebase - London Acton  ,5.02,  ,  ,  ,340.49, utilities, 
10-Mar-18, Sainsbury's  ,46.37,  ,  ,  ,345.51, groceries, 
10-Mar-18, Sainsbury's  ,10.5,  ,  ,  ,391.88, groceries, 
09-Mar-18, Payment from Kamenskikh K  ,  ,11.5,  ,  ,402.38, general, ZIMA
09-Mar-18, Payment from Kamenskikh K  ,  ,185,  ,  ,390.88, general, APRIL TRIP
09-Mar-18, Planet Organic  ,4.5,  ,  ,  ,205.88, groceries, 
07-Mar-18, Planet Organic  ,4.5,  ,  ,  ,210.38, groceries, 
07-Mar-18, Ryanair     22400000m2m6n  ,194.78,  ,  ,  ,214.88, travel, 
07-Mar-18, TortelliniCup London  ,8.2,  ,  ,  ,409.66, restaurants, 
07-Mar-18, To Falk Siegel  ,45,  ,  ,  ,417.86, transfers, 
06-Mar-18, Airbnb * Hmwkzhzbrs FX Rate £1 = €1.1147 ,160.09,  ,  EUR 178.46 ,  ,462.86, travel, 
06-Mar-18, Pp*transformdr  ,4.99,  ,  ,  ,622.95, entertainment, 
06-Mar-18, Hilco Supermarket Ltd  ,34.28,  ,  ,  ,627.94, groceries, 
06-Mar-18, Transport for London  ,3,  ,  ,  ,662.22, transport, 
06-Mar-18, Fierce Grace West  ,22,  ,  ,  ,665.22, health, 
05-Mar-18, Buongiorno e Buonasera  ,11.46,  ,  ,  ,687.22, restaurants, 
05-Mar-18, Co-op Food - Strand  ,7.87,  ,  ,  ,698.68, groceries, 
05-Mar-18, G&H Bottrill  ,9.1,  ,  ,  ,706.55, groceries, 
05-Mar-18, Transport for London  ,4.8,  ,  ,  ,715.65, transport, 
05-Mar-18, Paul Smith Avery Row  ,185,  ,  ,  ,720.45, shopping, 
04-Mar-18, Transport for London  ,2.4,  ,  ,  ,905.45, transport, 
04-Mar-18, Planet Organic  ,11.49,  ,  ,  ,907.85, groceries, 
03-Mar-18, Tfl.gov.uk  ,6.8,  ,  ,  ,919.34, transport, 
02-Mar-18, To Luca Mircoli  ,16,  ,  ,  ,926.14, transfers, 
02-Mar-18, TortelliniCup London  ,6.7,  ,  ,  ,942.14, restaurants, 
01-Mar-18, To Christopher Maclean  ,1,,,,,,
01-Mar-18, Exchange  to GBP FX Rate £1 = €1.1277 ,  ,709.38,  EUR 800.00 ,  ,2,,
01-Mar-18, To Luca Mircoli  ,10,  ,  ,  ,1,,
28-Feb-18, Payment from L Maresca  ,  ,400,  ,  ,1,,
28-Feb-18, Payment from Complete Accountin  ,  ,1,,,,,
27-Feb-18, Cafe Noir Ltd  ,4,  ,  ,  ,0.6, groceries, 
26-Feb-18, 2 Lower John St. London W1R 3PD  ,30,  ,  ,  ,4.6, restaurants, 
26-Feb-18, JOE & THE JUICE  ,3.15,  ,  ,  ,34.6, restaurants, 
26-Feb-18, JOE & THE JUICE  ,13.35,  ,  ,  ,37.75, restaurants, 
26-Feb-18, Chapter Spitalfields  ,10,  ,  ,  ,51.1, restaurants, 
25-Feb-18, Transport for London  ,2.4,  ,  ,  ,61.1, transport, 
24-Feb-18, To Lorenz Maresca  ,9.59,  ,  ,  ,63.5, transfers, 
24-Feb-18, Park Plaza Sherlock Holmes London  ,2.5,  ,  ,  ,73.09, restaurants, 
24-Feb-18, Transport for London  ,2.4,  ,  ,  ,75.59, transport, 
23-Feb-18, Transport for London  ,7.9,  ,  ,  ,77.99, transport, 
21-Feb-18, Ole & Steen  ,8.2,  ,  ,  ,85.89, groceries, 
21-Feb-18, TortelliniCup London  ,8,  ,  ,  ,94.09, restaurants, 
21-Feb-18, Planet Organic  ,13.98,  ,  ,  ,102.09, groceries, 
21-Feb-18, Transport for London  ,4.4,  ,  ,  ,116.07, transport, 
20-Feb-18, To Wioleta Bogalecka  ,70,  ,  ,  ,120.47, transfers, 
20-Feb-18, Christ Church London: Central London  ,7.5,  ,  ,  ,190.47, services, 
20-Feb-18, Sainsbury's  ,0.7,  ,  ,  ,197.97, groceries, 
19-Feb-18, Payment from Kamenskikh K  ,  ,7,  ,  ,198.67, general, BREAKFAST
19-Feb-18, Caffe Concerto  ,8.89,  ,  ,  ,191.67, restaurants, 
19-Feb-18, the Hop Locker Ltd  ,6,  ,  ,  ,200.56, shopping, 
19-Feb-18, Lul Ticket Machine  ,10,  ,  ,  ,206.56, transport, 
19-Feb-18, Transport for London  ,1.5,  ,  ,  ,216.56, transport, 
18-Feb-18, To Paolo Schiavone  ,100,  ,  ,  ,218.06, transfers, 
18-Feb-18, Va Swiss Cottage  ,88,  ,  ,  ,318.06, entertainment, 
18-Feb-18, Transport for London  ,4.8,  ,  ,  ,406.06, transport, 
18-Feb-18, TortelliniCup London  ,6.1,  ,  ,  ,410.86, restaurants, 
17-Feb-18, McDonald's  ,4.27,  ,  ,  ,416.96, restaurants, 
17-Feb-18, Regents Sports And Rec  ,1,  ,  ,  ,421.23, services, 
17-Feb-18, Park Plaza Sherlock Holmes London  ,17.41,  ,  ,  ,422.23, restaurants, 
17-Feb-18, Transport for London  ,5.6,  ,  ,  ,439.64, transport, 
16-Feb-18, To Lorenz Maresca  ,25,  ,  ,  ,445.24, transfers, 
16-Feb-18, Transport for London  ,4.8,  ,  ,  ,470.24, transport, 
16-Feb-18, Sainsbury's  ,11.35,  ,  ,  ,475.04, groceries, 
16-Feb-18, Tesco Superstore  ,23.98,  ,  ,  ,486.39, groceries, 
16-Feb-18, Todich Floral Design - London florist  ,2.5,  ,  ,  ,510.37, shopping, 
16-Feb-18, Exchange  to GBP FX Rate £1 = €1.1267 ,  ,443.76,  EUR 500.00 ,  ,512.87, general, 
15-Feb-18, Transport for London  ,2.9,  ,  ,  ,69.11, transport, 
15-Feb-18, Hilco Supermarket Ltd  ,9.99,  ,  ,  ,72.01, groceries, 
15-Feb-18, Vapiano  ,22.95,  ,  ,  ,82, restaurants, 
14-Feb-18, Pinocchios  ,68.2,  ,  ,  ,104.95, restaurants, 
14-Feb-18, Ahi Poke  ,11.45,  ,  ,  ,173.15, restaurants, 
14-Feb-18, Transport for London  ,2.9,  ,  ,  ,184.6, transport, 
13-Feb-18, To Kseniya Kamen  ,15,  ,  ,  ,187.5, transfers, 
13-Feb-18, Transport for London  ,7.9,  ,  ,  ,202.5, transport, 
13-Feb-18, Transport for London  ,4.8,  ,  ,  ,210.4, transport, 
13-Feb-18, Fucina  ,7.9,  ,  ,  ,215.2, restaurants, 
13-Feb-18, Marks & Spencer Canterbury  ,10,  ,  ,  ,223.1, groceries, 
13-Feb-18, Costa Coffee  ,6.65,  ,  ,  ,233.1, restaurants, 
12-Feb-18, Sainsbury's  ,17.6,  ,  ,  ,239.75, groceries, 
12-Feb-18, Waitrose  ,3.74,  ,  ,  ,257.35, groceries, 
12-Feb-18, Bill's Baker Street Restaurant  ,24.75,  ,  ,  ,261.09, restaurants, 
12-Feb-18, TortelliniCup London  ,9,  ,  ,  ,285.84, restaurants, 
11-Feb-18, To Lorenz Maresca  ,30,  ,  ,  ,294.84, transfers, 
11-Feb-18, To Luca Mircoli  ,10,  ,  ,  ,324.84, transfers, 
11-Feb-18, Planet Organic  ,19.94,  ,  ,  ,334.84, groceries, 
10-Feb-18, Cash at O2 Finchley Road 2  ,20,  ,  ,  ,354.78, cash, 
10-Feb-18, Tesco Superstore  ,10.24,  ,  ,  ,374.78, groceries, 
10-Feb-18, JOE & THE JUICE  ,8.3,  ,  ,  ,385.02, restaurants, 
09-Feb-18, TortelliniCup London  ,5.5,  ,  ,  ,393.32, restaurants, 
09-Feb-18, Transport for London  ,5.5,  ,  ,  ,398.82, transport, 
07-Feb-18, To Lorenz Maresca  ,20,  ,  ,  ,404.32, transfers, 
07-Feb-18, Exchange  to GBP FX Rate £1 = €1.1312 ,  ,424.32,  EUR 480.00 ,  ,424.32, general, 
07-Feb-18, Exchange  to GBP FX Rate £1 = €1.1258 ,  ,2.33,  EUR 2.63 ,  ,0, general, 
07-Feb-18, Cash at Baker Street  ,30,  ,  ,  ,-2.33, cash, 
05-Feb-18, Cash at Sainsbury's Bank  ,10,  ,  ,  ,27.67, cash, 
05-Feb-18, Transport for London  ,3,  ,  ,  ,37.67, transport, 
05-Feb-18, TortelliniCup London  ,3,  ,  ,  ,40.67, restaurants, 
04-Feb-18, To Lorenz Maresca  ,71,  ,  ,  ,43.67, transfers, 
04-Feb-18, Park Plaza Sherlock Holmes London  ,8.37,  ,  ,  ,114.67, restaurants, 
04-Feb-18, Transport for London  ,4.8,  ,  ,  ,123.04, transport, 
04-Feb-18, Tesco Superstore  ,1.8,  ,  ,  ,127.84, groceries, 
04-Feb-18, Sainsbury's  ,20.9,  ,  ,  ,129.64, groceries, 
04-Feb-18, Park Plaza Sherlock Holmes London  ,1.5,  ,  ,  ,150.54, restaurants, 
04-Feb-18, Park Plaza Sherlock Holmes London  ,3.95,  ,  ,  ,152.04, restaurants, 
04-Feb-18, Park Plaza Sherlock Holmes London  ,3.5,  ,  ,  ,155.99, restaurants, 
03-Feb-18, To Lucien Umlauf  ,20,  ,  ,  ,159.49, transfers, 
03-Feb-18, Park Plaza Sherlock Holmes London  ,1,  ,  ,  ,179.49, restaurants, 
03-Feb-18, Park Plaza Sherlock Holmes London  ,11.07,  ,  ,  ,180.49, restaurants, 
03-Feb-18, Park Plaza Sherlock Holmes London  ,1.9,  ,  ,  ,191.56, restaurants, 
03-Feb-18, The One And Only Deisign  ,49,  ,  ,  ,193.46, shopping, 
03-Feb-18, Marylebone High Street Express  ,6.45,  ,  ,  ,242.46, groceries, 
02-Feb-18, Transport for London  ,2.4,  ,  ,  ,248.91, transport, 
01-Feb-18, To Christopher Maclean  ,1,,,,,,
01-Feb-18, Exchange  to GBP FX Rate £1 = €1.1447 ,  ,436.76,  EUR 500.00 ,  ,1,,
01-Feb-18, Payment from L Maresca  ,  ,318,  ,  ,1,,
31-Jan-18, Payment from Complete Accountin  ,  ,842.71,  ,  ,846.55, general,6.00906E+13
31-Jan-18, Transport for London  ,2.9,  ,  ,  ,3.84, transport, 
31-Jan-18, National Express Limit  ,15,  ,  ,  ,6.74, transport, 
30-Jan-18, To Moshtaq Latifi  ,70,  ,  ,  ,21.74, transfers, 
30-Jan-18, Top-Up by *4414  ,  ,10,  ,  ,91.74, general, 
30-Jan-18, Payment from L Maresca  ,  ,70,  ,  ,81.74, general, MONEY TRANSFER
30-Jan-18, Transport for London  ,1.5,  ,  ,  ,11.74, transport, 
30-Jan-18, Hilco Supermarket Ltd  ,15.73,  ,  ,  ,13.24, groceries, 
30-Jan-18, Basement Sate  ,33.4,  ,  ,  ,28.97, restaurants, 
29-Jan-18, M&S Bond Street Simply Food  ,12.29,  ,  ,  ,62.37, groceries, 
29-Jan-18, London Borough of Islington  ,5.62,  ,  ,  ,74.66, restaurants, 
29-Jan-18, Transport for London  ,3.9,  ,  ,  ,80.28, transport, 
29-Jan-18, Transport for London  ,2.4,  ,  ,  ,84.18, transport, 
28-Jan-18, From Leon Hucht  ,  ,34,  ,  ,86.58, transfers, 
28-Jan-18, Tesco Superstore  ,6.75,  ,  ,  ,52.58, groceries, 
27-Jan-18, Park Plaza Sherlock Holmes London  ,14.22,  ,  ,  ,59.33, restaurants, 
27-Jan-18, Marylebone  ,5.1,  ,  ,  ,73.55, restaurants, 
23-Jan-18, Transport for London  ,3.9,  ,  ,  ,78.65, transport, 
23-Jan-18, Tesco Superstore  ,6.04,  ,  ,  ,82.55, groceries, 
23-Jan-18, Transport for London  ,2.4,  ,  ,  ,88.59, transport, 
22-Jan-18, Waterstones  ,6.46,  ,  ,  ,90.99, restaurants, 
22-Jan-18, Whole Foods Market  ,27.39,  ,  ,  ,97.45, groceries, 
22-Jan-18, Whole Foods Market  ,4.99,  ,  ,  ,124.84, groceries, 
22-Jan-18, Feng Sushi West  ,112,  ,  ,  ,129.83, restaurants, 
21-Jan-18, Iqos  ,8,  ,  ,  ,241.83, shopping, 
21-Jan-18, Princi  ,8.2,  ,  ,  ,249.83, restaurants, 
20-Jan-18, Cash at Hsbc  ,40,  ,  ,  ,258.03, cash, 
20-Jan-18, Cahoots  ,78.75,  ,  ,  ,298.03, restaurants, 
19-Jan-18, L'Antica Pizzeria da Michele  ,19.09,  ,  ,  ,376.78, restaurants, 
19-Jan-18, Mr Lee  ,9,  ,  ,  ,395.87, shopping, 
19-Jan-18, Marylebone  ,2.7,  ,  ,  ,404.87, restaurants, 
19-Jan-18, Transport for London  ,4.8,  ,  ,  ,407.57, transport, 
17-Jan-18, To Rix Training  ,100,  ,  ,  ,412.37, transfers, 
17-Jan-18, To Lorenz Maresca  ,200,  ,  ,  ,512.37, transfers, 
17-Jan-18, Exchange  to GBP FX Rate £1 = €1.1273 ,  ,709.64,  EUR 800.00 ,  ,712.37, general, 
08-Jan-18, Marylebone  ,2.7,  ,  ,  ,2.73, restaurants, 
08-Jan-18, Starbucks Coffee  ,6.4,  ,  ,  ,5.43, restaurants, 
08-Jan-18, aliexpress  ,1.18,  ,  ,  ,11.83, shopping, 
08-Jan-18, Transport for London  ,2.4,  ,  ,  ,13.01, transport, 
08-Jan-18, Park Plaza Sherlock Holmes London  ,1.5,  ,  ,  ,15.41, restaurants, 
08-Jan-18, Etnacoffee  ,1.75,  ,  ,  ,16.91, restaurants, 
08-Jan-18, Etnacoffee  ,17.3,  ,  ,  ,18.66, restaurants, 
08-Jan-18, Marylebone Books  ,2.2,  ,  ,  ,35.96, shopping, 
07-Jan-18, To Paolo Schiavone  ,2,,,,,,
07-Jan-18, To Lorenz Maresca  ,100,  ,  ,  ,2,,
06-Jan-18, To Lorenz Maresca  ,20,  ,  ,  ,2,,
06-Jan-18, Card Delivery Fee  ,12,  ,  ,  ,2,,
06-Jan-18, To Lorenz Maresca  ,50,  ,  ,  ,2,,
06-Jan-18, To Moshtaq Latifi  ,25,  ,  ,  ,2,,
05-Jan-18, Ahi Poke  ,11.45,  ,  ,  ,2,,
04-Jan-18, To Luca Mircoli  ,10,  ,  ,  ,2,,
02-Jan-18, Transport for London  ,2.4,  ,  ,  ,2,,
02-Jan-18, Transport for London  ,5.4,  ,  ,  ,2,,
02-Jan-18, Cash at ATM Raphaels Bank Fee: 0.06 ,20.06,  ,  ,  ,2,,
02-Jan-18, To Lorenz Maresca  ,40,  ,  ,  ,2,,
02-Jan-18, Naturalicious Uk Ltd  ,4.25,  ,  ,  ,2,,
02-Jan-18, The Market Porter  ,9.7,  ,  ,  ,2,,
31-Dec-17, Payment from L Maresca  ,  ,650,  ,  ,2,,
31-Dec-17, To Christopher Maclean  ,1,,,,,,
31-Dec-17, Exchange  to GBP FX Rate £1 = €1.1319 ,  ,1,,,,,
30-Dec-17, To Luca Mircoli  ,10,  ,  ,  ,1,,
29-Dec-17, Sainsbury's  ,32.33,  ,  ,  ,1,,
29-Dec-17, TortelliniCup London  ,9.8,  ,  ,  ,1,,
29-Dec-17, Google aclap Sarl  ,2.99,  ,  ,  ,1,,
28-Dec-17, Transport for London  ,8.1,  ,  ,  ,1,,
28-Dec-17, Cash at Unicredit - Fium.arr FX Rate £1 = €1.1266 ,44.38,  ,  EUR 50.00 ,  ,1,,
28-Dec-17, Supersave  ,1.7,  ,  ,  ,2,,
23-Dec-17, Exchange GBP to  FX Rate £1 = €1.1200 ,100,  ,  GBP 100.00 ,  ,2,,
22-Dec-17, Exchange GBP to  FX Rate £1 = €1.1255 ,20,  ,  GBP 20.00 ,  ,2,,
21-Dec-17, Exchange GBP to  FX Rate £1 = €1.1275 ,200,  ,  GBP 200.00 ,  ,2,,
21-Dec-17, Payment from Complete Tax Sol  ,  ,772.1,  ,  ,2,,
21-Dec-17, To Moshtaq Latifi  ,50,  ,  ,  ,1,,
20-Dec-17, To Lorenz Maresca  ,100,  ,  ,  ,1,,
20-Dec-17, Pret A Manger  ,3.95,  ,  ,  ,1,,
19-Dec-17, UNIQLO Europe Limited  ,34.9,  ,  ,  ,1,,
19-Dec-17, Holland & Barrett  ,25.48,  ,  ,  ,1,,
19-Dec-17, Starbucks Coffee  ,3.75,  ,  ,  ,1,,
19-Dec-17, Tesco Superstore  ,1.56,  ,  ,  ,1,,
19-Dec-17, Island Poke  ,12.35,  ,  ,  ,1,,
19-Dec-17, Cash at Royal Bank of Scotland  ,10,  ,  ,  ,1,,
18-Dec-17, My Place Soho  ,11.5,  ,  ,  ,1,,
18-Dec-17, Whole Foods Market  ,1.49,  ,  ,  ,1,,
18-Dec-17, Whole Foods Market  ,9.35,  ,  ,  ,1,,
18-Dec-17, Transport for London  ,6.3,  ,  ,  ,1,,
18-Dec-17, Mews of Mayfair  ,36,  ,  ,  ,1,,
18-Dec-17, Transport for London  ,3,  ,  ,  ,1,,
18-Dec-17, Brondes Dry Cleaners  ,16,  ,  ,  ,1,,
18-Dec-17, Sainsbury's  ,28.65,  ,  ,  ,1,,
18-Dec-17, TortelliniCup London  ,8.6,  ,  ,  ,1,,
18-Dec-17, Burger & Lobster  ,38,  ,  ,  ,1,,
18-Dec-17, Hush  ,20.79,  ,  ,  ,1,,
18-Dec-17, Transport for London  ,4.8,  ,  ,  ,1,,
18-Dec-17, Park Plaza Sherlock Holmes London  ,1.5,  ,  ,  ,1,,
18-Dec-17, Park Plaza Sherlock Holmes London  ,11.07,  ,  ,  ,1,,
16-Dec-17, To Lorenz Maresca  ,100,  ,  ,  ,1,,
15-Dec-17, To Kseniya Kamen  ,9,  ,  ,  ,2,,
15-Dec-17, Marylebone High Street Express  ,3.9,  ,  ,  ,2,,
15-Dec-17, Marylebone Books  ,4.99,  ,  ,  ,2,,
15-Dec-17, Park Plaza Sherlock Holmes London  ,1.5,  ,  ,  ,2,,
14-Dec-17, Cash at E00555800000000  ,20,  ,  ,  ,2,,
14-Dec-17, Chipotle Mexican Grill  ,8.35,  ,  ,  ,2,,
14-Dec-17, TortelliniCup London  ,6.7,  ,  ,  ,2,,
13-Dec-17, Transport for London  ,4.8,  ,  ,  ,2,,
13-Dec-17, Cash at ATM Raphaels Bank  ,20,  ,  ,  ,2,,
12-Dec-17, Transport for London  ,5.3,  ,  ,  ,2,,
12-Dec-17, Park Plaza Sherlock Holmes London  ,10.3,  ,  ,  ,2,,
12-Dec-17, Tesco Superstore  ,6,  ,  ,  ,2,,
11-Dec-17, Transport for London  ,2.4,  ,  ,  ,2,,
11-Dec-17, Taxi Workneh Haile  ,17.8,  ,  ,  ,2,,
11-Dec-17, Tesco Express  ,11.8,  ,  ,  ,2,,
11-Dec-17, KOKO  ,8,  ,  ,  ,2,,
11-Dec-17, Boneca Tickets  ,38.5,  ,  ,  ,2,,
10-Dec-17, To Luca Mircoli  ,10,  ,  ,  ,2,,
09-Dec-17, Payment from L Maresca  ,  ,50,  ,  ,2,,
09-Dec-17, To Mostag Latifi  ,180,  ,  ,  ,2,,
08-Dec-17, Ahi Poke  ,10.95,  ,  ,  ,2,,
08-Dec-17, Honest Burgers - Liverpool St  ,23.95,  ,  ,  ,2,,
08-Dec-17, Transport for London  ,2.9,  ,  ,  ,2,,
07-Dec-17, Princi  ,11.9,  ,  ,  ,2,,
07-Dec-17, Princi  ,10.4,  ,  ,  ,2,,
07-Dec-17, Transport for London  ,2.4,  ,  ,  ,2,,
07-Dec-17, Payment from Gallicchio G A  ,  ,112.5,  ,  ,2,,
06-Dec-17, Payment from L Maresca  ,  ,1,,,,,
05-Dec-17, Transport for London  ,7.8,  ,  ,  ,1,,
05-Dec-17, Chipotle Mexican Grill  ,9.65,  ,  ,  ,1,,
05-Dec-17, Park Plaza Sherlock Holmes London  ,5,  ,  ,  ,1,,
05-Dec-17, Marylebone Books  ,9.99,  ,  ,  ,1,,
04-Dec-17, Transport for London  ,1.5,  ,  ,  ,1,,
04-Dec-17, Tesco Superstore  ,21.4,  ,  ,  ,1,,
04-Dec-17, Tesco Superstore  ,4.25,  ,  ,  ,1,,
04-Dec-17, Hing Yip Oriental Supermarket Ltd  ,31.59,  ,  ,  ,1,,
04-Dec-17, Naturalicious Uk Ltd  ,4.25,  ,  ,  ,1,,
04-Dec-17, Gitane  ,17,  ,  ,  ,1,,
04-Dec-17, Transport for London  ,2.4,  ,  ,  ,1,,
04-Dec-17, Daks Simpson  ,10,  ,  ,  ,1,,
04-Dec-17, Carluccio's  ,13.75,  ,  ,  ,1,,
04-Dec-17, Espressamente Illy Coffee Shop. London  ,9.8,  ,  ,  ,1,,
04-Dec-17, Transport for London  ,2.4,  ,  ,  ,1,,
04-Dec-17, The Connaught  ,83.25,  ,  ,  ,1,,
04-Dec-17, Claridge's  ,25.6,  ,  ,  ,1,,
04-Dec-17, Park Plaza Sherlock Holmes London  ,1.9,  ,  ,  ,1,,
04-Dec-17, Park Plaza Sherlock Holmes London  ,11.97,  ,  ,  ,1,,
04-Dec-17, Daks Simpson  ,235,  ,  ,  ,1,,
01-Dec-17, Hing Yip Oriental Supermarket Ltd  ,15.24,  ,  ,  ,1,,
01-Dec-17, Sainsbury's  ,5.75,  ,  ,  ,1,,
30-Nov-17, Payment from L Maresca  ,  ,616,  ,  ,1,,
30-Nov-17, Payment from Complete Accountin  ,  ,1,,,,,
30-Nov-17, Cash at Sainsbury's Fee: 0.40 ,20.4,  ,  ,  ,59.47, cash, 
30-Nov-17, Cash at Luton Fee: 0.20 ,10.2,  ,  ,  ,79.87, cash, 
30-Nov-17, Island Poke  ,10.05,  ,  ,  ,90.07, restaurants, 
30-Nov-17, TortelliniCup London  ,6.1,  ,  ,  ,100.12, restaurants, 
30-Nov-17, Va Swiss Cottage  ,9,  ,  ,  ,106.22, entertainment, 
29-Nov-17, Transport for London  ,3.9,  ,  ,  ,115.22, transport, 
29-Nov-17, Tsgn  ,14.6,  ,  ,  ,119.12, transport, 
29-Nov-17, Addison Lee  ,11.65,  ,  ,  ,133.72, transport, 
28-Nov-17, Transport for London  ,2.4,  ,  ,  ,145.37, transport, 
28-Nov-17, Cash at Royal Bank of Scotland Fee: 0.40 ,20.4,  ,  ,  ,147.77, cash, 
27-Nov-17, Adventure Bar  ,23.6,  ,  ,  ,168.17, restaurants, 
27-Nov-17, Transport for London  ,2.4,  ,  ,  ,191.77, transport, 
27-Nov-17, itsu  ,9.23,  ,  ,  ,194.17, restaurants, 
27-Nov-17, Sainsbury's Local  ,3.7,  ,  ,  ,203.4, groceries, 
27-Nov-17, Park Plaza Sherlock Holmes London  ,11.97,  ,  ,  ,207.1, restaurants, 
27-Nov-17, Park Plaza Sherlock Holmes London  ,1.5,  ,  ,  ,219.07, restaurants, 
24-Nov-17, To Bruno Arturo Fragnito  ,10,  ,  ,  ,220.57, transfers, 
24-Nov-17, Payment from R Petkov  ,  ,13,  ,  ,230.57, general, UNI
24-Nov-17, Payment from Mutombo C  ,  ,8,  ,  ,217.57, general, KFFF
24-Nov-17, Island Poke  ,12.35,  ,  ,  ,209.57, restaurants, 
24-Nov-17, Transport for London  ,4.4,  ,  ,  ,221.92, transport, 
24-Nov-17, Tsgn  ,13.5,  ,  ,  ,226.32, transport, 
23-Nov-17, Island Poke  ,8.85,  ,  ,  ,239.82, restaurants, 
23-Nov-17, Sainsbury's  ,31.05,  ,  ,  ,248.67, groceries, 
22-Nov-17, Transport for London  ,1.5,  ,  ,  ,279.72, transport, 
22-Nov-17, Cash at ATM Raphaels Bank Fee: 0.60 ,30.6,  ,  ,  ,281.22, cash, 
22-Nov-17, Tesco Superstore  ,4.29,  ,  ,  ,311.82, groceries, 
22-Nov-17, Tesco Superstore  ,18.6,  ,  ,  ,316.11, groceries, 
21-Nov-17, Exchange  to GBP FX Rate £1 = €1.1292 ,  ,318.8,  EUR 360.00 ,  ,334.71, general, 
20-Nov-17, Cash at 22201973  ,150.11,  ,  ,  ,15.91, cash, 
20-Nov-17, Transport for London  ,1.5,  ,  ,  ,166.02, transport, 
20-Nov-17, Iz *brewandwild  ,6.75,  ,  ,  ,167.52, restaurants, 
20-Nov-17, Tsgn  ,14.6,  ,  ,  ,174.27, transport, 
20-Nov-17, Wasabi Sushi & Bento  ,19.77,  ,  ,  ,188.87, restaurants, 
17-Nov-17, Green Man  ,1.7,  ,  ,  ,208.64, restaurants, 
17-Nov-17, Hing Yip Oriental Supermarket Ltd  ,15.07,  ,  ,  ,210.34, groceries, 
17-Nov-17, Tesco Superstore  ,3.65,  ,  ,  ,225.41, groceries, 
17-Nov-17, Gitane  ,11.8,  ,  ,  ,229.06, restaurants, 
16-Nov-17, Payment from L Maresca  ,  ,200,  ,  ,240.86, general, MONEY TRANSFER
16-Nov-17, Transport for London  ,2.4,  ,  ,  ,40.86, transport, 
16-Nov-17, Island Poke  ,9.35,  ,  ,  ,43.26, restaurants, 
16-Nov-17, Island Poke  ,12.35,  ,  ,  ,52.61, restaurants, 
14-Nov-17, Sportsdirect  ,12.99,  ,  ,  ,64.96, shopping, 
14-Nov-17, Transport for London  ,7.8,  ,  ,  ,77.95, transport, 
14-Nov-17, TortelliniCup London  ,6.7,  ,  ,  ,85.75, restaurants, 
14-Nov-17, Cash at Royal Bank of Scotland  ,20,  ,  ,  ,92.45, cash, 
14-Nov-17, Cash at Royal Bank of Scotland  ,10,  ,  ,  ,112.45, cash, 
13-Nov-17, The Ginger Pig  ,13,  ,  ,  ,122.45, groceries, 
13-Nov-17, Regents Sports And Rec  ,7,  ,  ,  ,135.45, services, 
13-Nov-17, Arch Climbing: Building One  ,3.5,  ,  ,  ,142.45, entertainment, 
13-Nov-17, Arch Climbing: Building One  ,13.5,  ,  ,  ,145.95, entertainment, 
13-Nov-17, Transport for London  ,2.4,  ,  ,  ,159.45, transport, 
13-Nov-17, Brondes Dry Cleaners  ,18,  ,  ,  ,161.85, services, 
13-Nov-17, Etnacoffee  ,20.15,  ,  ,  ,179.85, restaurants, 
13-Nov-17, Sainsbury's  ,16.1,  ,  ,  ,200, groceries, 
10-Nov-17, Transport for London  ,7.8,  ,  ,  ,216.1, transport, 
10-Nov-17, Sainsbury's Local  ,1.85,  ,  ,  ,223.9, groceries, 
10-Nov-17, Bakerstposterprinting  ,40.32,  ,  ,  ,225.75, services, 
09-Nov-17, Payment from L Maresca  ,  ,15,  ,  ,266.07, general, MONEY TRANSFER
09-Nov-17, To Leopoldo Carbone  ,20,  ,  ,  ,251.07, transfers, 
09-Nov-17, To Bruno Fragnito  ,5,  ,  ,  ,271.07, transfers, 
09-Nov-17, Exchange  to GBP FX Rate £1 = €1.1277 ,  ,177.35,  EUR 200.00 ,  ,276.07, general, 
09-Nov-17, M&S Cambridge Rail Simply Food  ,3.7,  ,  ,  ,98.72, groceries, 
08-Nov-17, Payment from L Maresca  ,  ,98,  ,  ,102.42, general, MONEY TRANSFER
07-Nov-17, Transport for London  ,2.4,  ,  ,  ,4.42, transport, 
06-Nov-17, Experimental Cocktail Club Chinatown  ,28.41,  ,  ,  ,6.82, restaurants, 
06-Nov-17, TortelliniCup London  ,6.7,  ,  ,  ,35.23, restaurants, 
06-Nov-17, Marylebone  ,1.2,  ,  ,  ,41.93, restaurants, 
03-Nov-17, Tesco Superstore  ,3.99,  ,  ,  ,43.13, groceries, 
03-Nov-17, Transport for London  ,2.9,  ,  ,  ,47.12, transport, 
03-Nov-17, ERGON London  ,3.6,  ,  ,  ,50.02, groceries, 
02-Nov-17, Ted S Grooming Room  ,14,  ,  ,  ,53.62, health, 
01-Nov-17, TortelliniCup London  ,6.7,  ,  ,  ,67.62, restaurants, 
01-Nov-17, Espressamente Illy Coffee Shop. London  ,5.4,  ,  ,  ,74.32, restaurants, 
01-Nov-17, Cash at Royal Bank of Scotland  ,20,  ,  ,  ,79.72, cash, 
31-Oct-17, To Christopher Maclean  ,1,,,,,,
31-Oct-17, Payment from Complete Tax Sol  ,  ,449.87,  ,  ,1,,
31-Oct-17, Tesco Superstore  ,32.55,  ,  ,  ,1,,
30-Oct-17, Shake Shack Leicester Square  ,4.95,  ,  ,  ,1,,
30-Oct-17, The Creperie  ,32.46,  ,  ,  ,1,,
30-Oct-17, Holland & Barrett  ,17.48,  ,  ,  ,1,,
30-Oct-17, Berezka  ,14.06,  ,  ,  ,1,,
30-Oct-17, Payment from L Maresca  ,  ,670,  ,  ,1,,
30-Oct-17, Island Poke  ,11.35,  ,  ,  ,463.35, restaurants, 
30-Oct-17, Waitrose  ,20.99,  ,  ,  ,474.7, groceries, 
30-Oct-17, Transport for London  ,1.5,  ,  ,  ,495.69, transport, 
30-Oct-17, The Blues Kitchen  ,9.5,  ,  ,  ,497.19, restaurants, 
30-Oct-17, The Blues Kitchen  ,9.5,  ,  ,  ,506.69, restaurants, 
30-Oct-17, The Blues Kitchen  ,19,  ,  ,  ,516.19, restaurants, 
30-Oct-17, The Blues Kitchen  ,14,  ,  ,  ,535.19, restaurants, 
30-Oct-17, Cash at Sainsbury's  ,20,  ,  ,  ,549.19, cash, 
30-Oct-17, Etnacoffee  ,4.25,  ,  ,  ,569.19, restaurants, 
30-Oct-17, Etnacoffee  ,9.4,  ,  ,  ,573.44, restaurants, 
28-Oct-17, Exchange  to GBP FX Rate £1 = €1.1366 ,  ,175.95,  EUR 200.00 ,  ,582.84, general, 
27-Oct-17, To Bruno Fragnito  ,10,  ,  ,  ,406.89, transfers, 
27-Oct-17, Holmes Place N  ,1,  ,  ,  ,416.89, entertainment, 
27-Oct-17, Holmes Place N  ,3.25,  ,  ,  ,417.89, entertainment, 
26-Oct-17, Tfl.gov.uk  ,7.8,  ,  ,  ,421.14, transport, 
26-Oct-17, Easyjetetv9lnf  ,175.44,  ,  ,  ,428.94, travel, 
26-Oct-17, Sainsbury's  ,12.4,  ,  ,  ,604.38, groceries, 
25-Oct-17, To Harish Bali  ,10,  ,  ,  ,616.78, transfers, 
25-Oct-17, Sainsbury's Local  ,4.25,  ,  ,  ,626.78, groceries, 
24-Oct-17, Exchange  to GBP FX Rate £1 = €1.1206 ,  ,629.01,  EUR 704.88 ,  ,631.03, general, 
23-Oct-17, Typeform Sl  ,28,  ,  ,  ,2.02, shopping, 
23-Oct-17, Espressamente Illy Coffee Shop. London  ,3.2,  ,  ,  ,30.02, restaurants, 
23-Oct-17, Transport for London  ,1.5,  ,  ,  ,33.22, transport, 
23-Oct-17, Park Plaza Sherlock Holmes London  ,8.37,  ,  ,  ,34.72, restaurants, 
20-Oct-17, Payment from Mutombo C  ,  ,6,  ,  ,43.09, general, KFFF
20-Oct-17, Transport for London  ,2.4,  ,  ,  ,37.09, transport, 
19-Oct-17, Cash at Sainsbury's  ,10,  ,  ,  ,39.49, cash, 
19-Oct-17, London College of Fashion  ,8.45,  ,  ,  ,49.49, shopping, 
19-Oct-17, Yalla Yalla  ,7.13,  ,  ,  ,57.94, restaurants, 
18-Oct-17, To Bruno Fragnito  ,53,  ,  ,  ,65.07, transfers, Buffo
18-Oct-17, Marks & Spencer Croydon  ,5,  ,  ,  ,118.07, groceries, 
18-Oct-17, Five Guys  ,15.95,  ,  ,  ,123.07, restaurants, 
18-Oct-17, itsu  ,9.98,  ,  ,  ,139.02, restaurants, 
18-Oct-17, Www.iqos.co.uk  ,59,  ,  ,  ,149, shopping, 
18-Oct-17, Marylebone High Street Express  ,1,  ,  ,  ,208, groceries, 
18-Oct-17, Sainsbury's  ,22.2,  ,  ,  ,209, groceries, 
18-Oct-17, Park Plaza Sherlock Holmes London  ,1.5,  ,  ,  ,231.2, restaurants, 
17-Oct-17, To iwoca  ,230.98,  ,  ,  ,232.7, transfers, BikeToWork - Lorenz
17-Oct-17, Transport for London  ,2,  ,  ,  ,463.68, transport, 
17-Oct-17, Transport for London  ,3.9,  ,  ,  ,465.68, transport, 
17-Oct-17, UoW  ,1.5,  ,  ,  ,469.58, restaurants, 
17-Oct-17, Park Plaza Sherlock Holmes London  ,1.5,  ,  ,  ,471.08, restaurants, 
16-Oct-17, Transport for London  ,3.9,  ,  ,  ,472.58, transport, 
16-Oct-17, Odeon Cinema London Tottenham Court  ,30.75,  ,  ,  ,476.48, entertainment, 
16-Oct-17, Honest Burgers - Soho  ,18.5,  ,  ,  ,507.23, restaurants, 
16-Oct-17, The Hoxton. Holborn  ,26.69,  ,  ,  ,525.73, restaurants, 
16-Oct-17, Espressamente Illy Coffee Shop. London  ,3.8,  ,  ,  ,552.42, restaurants, 
16-Oct-17, Park Plaza Sherlock Holmes London  ,3,  ,  ,  ,556.22, restaurants, 
16-Oct-17, Park Plaza Sherlock Holmes London  ,9.27,  ,  ,  ,559.22, restaurants, 
16-Oct-17, Marylebone Books  ,5.19,  ,  ,  ,568.49, shopping, 
13-Oct-17, To Luca Mircoli  ,10,  ,  ,  ,573.68, transfers, 
13-Oct-17, To Lorenz Maresca  ,60,  ,  ,  ,583.68, transfers, 
13-Oct-17, Exchange  to GBP FX Rate £1 = €1.1244 ,  ,622.51,  EUR 700.00 ,  ,643.68, general, 
05-Oct-17, Brondes Dry Cleaners  ,10,  ,  ,  ,21.17, services, 
05-Oct-17, London Stansted Airport  ,9.98,  ,  ,  ,31.17, restaurants, 
04-Oct-17, Chef Academy London  ,4.85,  ,  ,  ,41.15, restaurants, 
04-Oct-17, Hing Yip Oriental Supermarket Ltd  ,12.79,  ,  ,  ,46, groceries, 
03-Oct-17, Cash at E00555800000000  ,10,  ,  ,  ,58.79, cash, 
03-Oct-17, Missguided  ,38.99,  ,  ,  ,68.79, shopping, 
02-Oct-17, Transport for London  ,1.5,  ,  ,  ,107.78, transport, 
02-Oct-17, Hing Yip Oriental Supermarket Ltd  ,4.78,  ,  ,  ,109.28, groceries, 
02-Oct-17, Hing Yip Oriental Supermarket Ltd  ,8.2,  ,  ,  ,114.06, groceries, 
02-Oct-17, Opium  ,30,  ,  ,  ,122.26, restaurants, 
02-Oct-17, Taro Restaurant  ,25.63,  ,  ,  ,152.26, restaurants, 
02-Oct-17, Tfl.gov.uk  ,7.8,  ,  ,  ,177.89, transport, 
02-Oct-17, Transport for London  ,1.5,  ,  ,  ,185.69, transport, 
02-Oct-17, Sainsbury's  ,12.2,  ,  ,  ,187.19, groceries, 
02-Oct-17, To Lorenz Maresca  ,50,  ,  ,  ,199.39, transfers, 
02-Oct-17, To Lorenz Maresca  ,80,  ,  ,  ,249.39, transfers, 
01-Oct-17, To Christopher Maclean  ,32,  ,  ,  ,329.39, transfers, 
01-Oct-17, To Lorenz Maresca  ,700,  ,  ,  ,361.39, transfers, 
30-Sep-17, To Lorenz Maresca  ,70,  ,  ,  ,1,,
30-Sep-17, Payment from Complete Tax Sol  ,  ,1,,,,,
22-Sep-17, JOE & THE JUICE  ,7.3,  ,  ,  ,22.89, restaurants, 
20-Sep-17, Payment from Iwoca Ltd  ,  ,12,  ,  ,30.19, general, WORK EXPENSE
19-Sep-17, Transport for London  ,2.9,  ,  ,  ,18.19, transport, 
19-Sep-17, Transport for London  ,2.4,  ,  ,  ,21.09, transport, 
18-Sep-17, Transport for London  ,2.4,  ,  ,  ,23.49, transport, 
18-Sep-17, Pret A Manger  ,4.19,  ,  ,  ,25.89, restaurants, 
18-Sep-17, Transport for London  ,2.4,  ,  ,  ,30.08, transport, 
17-Sep-17, To Paolo Schiavone  ,10,  ,  ,  ,32.48, transfers, 
17-Sep-17, Top-up via Apple Pay  ,  ,10,  ,  ,42.48, general, 
13-Sep-17, itsu  ,11.87,  ,  ,  ,32.48, restaurants, 
13-Sep-17, Acai berry  ,6.5,  ,  ,  ,44.35, restaurants, 
12-Sep-17, Transport for London  ,2.9,  ,  ,  ,50.85, transport, 
12-Sep-17, Tesco Superstore  ,10.06,  ,  ,  ,53.75, groceries, 
12-Sep-17, Tesco Superstore  ,0.1,  ,  ,  ,63.81, groceries, 
12-Sep-17, Gitane  ,9.2,  ,  ,  ,63.91, restaurants, 
11-Sep-17, Transport for London  ,5.4,  ,  ,  ,73.11, transport, 
11-Sep-17, Transport for London  ,4.8,  ,  ,  ,78.51, transport, 
11-Sep-17, Cash at Sainsbury's  ,20,  ,  ,  ,83.31, cash, 
11-Sep-17, Hing Yip Oriental Supermarket Ltd  ,13.5,  ,  ,  ,103.31, groceries, 
11-Sep-17, Whole Foods Market  ,7.63,  ,  ,  ,116.81, groceries, 
11-Sep-17, Transport for London  ,2.9,  ,  ,  ,124.44, transport, 
11-Sep-17, Franco Manca  ,8,  ,  ,  ,127.34, restaurants, 
11-Sep-17, Holmes Place Health Clubs  ,20,  ,  ,  ,135.34, entertainment, 
08-Sep-17, Cash at E00555800000000  ,10,  ,  ,  ,155.34, cash, 
08-Sep-17, Sainsbury's Local  ,20.6,  ,  ,  ,165.34, groceries, 
06-Sep-17, Ahi Poke  ,10.45,  ,  ,  ,185.94, restaurants, 
06-Sep-17, London College of Fashion  ,0.8,  ,  ,  ,196.39, shopping, 
06-Sep-17, Ranya Fresh Fish  ,6,  ,  ,  ,197.19, groceries, 
05-Sep-17, Transport for London  ,2.4,  ,  ,  ,203.19, transport, 
05-Sep-17, Transport for London  ,5.3,  ,  ,  ,205.59, transport, 
05-Sep-17, Holmes Place Mayfair  ,4.05,  ,  ,  ,210.89, health, 
05-Sep-17, H.T. Harris  ,6,  ,  ,  ,214.94, groceries, 
05-Sep-17, Nando's  ,11.25,  ,  ,  ,220.94, restaurants, 
04-Sep-17, Yoomoo  ,9.85,  ,  ,  ,232.19, restaurants, 
04-Sep-17, La Pizzica Ltd  ,17,  ,  ,  ,242.04, restaurants, 
04-Sep-17, La Pizzica Restaurant  ,32.6,  ,  ,  ,259.04, restaurants, 
04-Sep-17, Cash at E00555800000000  ,20,  ,  ,  ,291.64, cash, 
04-Sep-17, The Clachan  ,9,  ,  ,  ,311.64, restaurants, 
01-Sep-17, To Lorenz Maresca  ,15,  ,  ,  ,320.64, transfers, 
01-Sep-17, To Christopher Maclean  ,1,,,,,,
01-Sep-17, To Lorenz Maresca  ,25,  ,  ,  ,1,,
31-Aug-17, Payment from L Maresca  ,  ,600,  ,  ,1,,
31-Aug-17, Transport for London  ,2.4,  ,  ,  ,1,,
31-Aug-17, Payment from Complete Accountin  ,  ,1,,,,,
26-Aug-17, Exchange GBP to  FX Rate £1 = €1.0748 ,50,  ,  GBP 50.00 ,  ,10, general, 
26-Aug-17, Payment from L Maresca  ,  ,60,  ,  ,60, general, MONEY TRANSFER
23-Aug-17, Exchange GBP to  FX Rate £1 = €1.0836 ,305,  ,  GBP 305.00 ,  ,0, general, 
23-Aug-17, Payment from L Maresca  ,  ,300,  ,  ,305, general, MONEY TRANSFER
11-Jul-17, Card Delivery Fee  ,5,  ,  ,  ,5, general, 
11-Jul-17, Top-up via Apple Pay  ,  ,10,  ,  ,10, general, 